Md^Xm, Md^Xm, Md^Xm, Md^Xm, Md^Xm, Md^Xm, Md^Xm, Md, Md, Md, Md, Md, Md, Md, Md, Md, Md, Mm^Xm, Mm^Xm, Mm^Xm, Mm^Xm, Mm^Xm
Md^Xm, Md^Xm, Md^Xm, Md^Xm, Md^Xm, Md^Xm, Md, Md, Hhd, Hhd, Hd, Hd, Hd, Ce, Ce, Md, Md, Md, Md^Xm, Md^Xm, Md^Xm, Mm^Xm
Md^Xm, Md^Xm, Md^Xm, Md^Xm, Md, Md, Dd^Do, Dd^Vdt, Hd, Hd, Hd, Hd, Hd, Hd, Hd, Ke, Ce, Hhd, Hhd, Md^Xm, Md^Xm, Md^Xm
Md^Xm, Md^Xm, Md^Xm, Md, Md, Md, Md, Hd, Md, Md, Md, Dd^Vda, Md, Hhd, Hd, Dd^Do, Ce, Hhd, Md, Md, Md^Xm, Md^Xm
Md^Xm, Md^Xm, Md, Md, Md, Md, Hd, Md, Md, Md, Md, Md, Md, Md, Hhd, Hd, Hd, Md, Md, Md, Md^Xm, Md^Xm
Md^Xm, Md^Xm, Md, Md, Hd, Hd, Md, Md, Dd^Vdt, Md, Md, Md, Md^Xm, Md, Md, Hd, Hd, Md, Md, Md, Md^Xm, Md^Xm
Md^Xm, Md^Xm, Md, Md, Hd, Md, Hd, Hd, Md, Md, Md^Xm, Md^Xm, Md^Xm, Md^Xm, Md, Hd, Hd, Md, Md, Md^Xm, Md^Xm, Md^Xm
Md^Xm, Md^Xm, Md, Hd, Gs, Hhd, Hd, Md, Md, Md, Md^Xm, Md^Xm, Md, Md, Md, Dd^Vdt, Hd, Gg, Md, Md^Xm, Md^Xm, Md^Xm
Md^Xm, Md^Xm, Md, Gd, Hd, Hhd, Md, Hd, Md, Md, Md^Xm, Md^Xm, Md, Md, Md, Hhd, Hd, Gs, Hhd, Md, Md^Xm, Md^Xm
Md^Xm, Md^Xm, Md, Dd^Vda, Hd, Md, Md, Hd, Md, Md, Md^Xm, Md^Xm, Md^Xm, Md, Md, Md, Hd, Gd, Md, Md, Md^Xm, Md^Xm
Md^Xm, Md^Xm, Md^Xm, Md, Hhd, Hd, Md, Hd, Gd, Md, Md^Xm, Md^Xm, Md^Xm, Md, Hhd, Hd, Hd, Gd, Md, Md, Md^Xm, Md^Xm
Md^Xm, Md^Xm, Md^Xm, Md, Md, Gd, Gs, Hd, Dd^Vdt, Hhd, Md, Md^Xm, Md^Xm, Hhd, Hhd, Hd, Hd, Dd^Vdt, Md, Md, Md^Xm, Md^Xm
Md^Xm, Md^Xm, Hhd, Md, Chr, Gd, Gg, Hd, Hd, Md, Md, Md^Xm, Md^Xm, Md^Xm, Md, Hd, Hd, Hd, Md, Md, Md^Xm, Md^Xm
Md^Xm, Hhd, Chr, Chr, Chr, Gd, Gg, Hd, Hd, Md, Md, Md^Xm, Md^Xm, Md^Xm, Md, Hd, Md, Md, Md, Md, Md^Xm, Md^Xm
Md^Xm, Md, Chr, 2 Khr, Chr, Gd, Gs, Hd, Md, Md, Md, Md^Xm, Md^Xm, Md^Xm, Md, Dd^Vda, Gs, Hhd, Hhd, Md^Xm, Md^Xm, Md^Xm
Md^Xm, Md, Chr, Chr, Hhd, Gd, Gs, Dd^Vda, Md, Md, Md^Xm, Md^Xm, Md^Xm, Md, Md, Gg, Gd, Md, Md^Xm, Md^Xm, Md^Xm, Md^Xm
Md^Xm, Md, Hhd, Chr, Hhd, Md, Gd, Gg, Hhd, Md, Md^Xm, Md^Xm, Md^Xm, Md, Hhd, Gg, Gd, Md, Md^Xm, Md^Xm, Md^Xm, Md^Xm
Md^Xm, Md^Xm, Md^Xm, Hhd, Md, Hd, Gd, Gd, Hhd, Md, Md^Xm, Md^Xm, Md^Xm, Md, Md, Gs, 1 Gd, Md, Md, Md^Xm, Md^Xm, Md^Xm
Md^Xm, Md^Xm, Md^Xm, Md^Xm, Md, Hd, Gd, Gd, Hhd, Md, Md^Xm, Md^Xm, Md^Xm, Md, Md, Hd, Gd, Hd, Md, Md^Xm, Md^Xm, Md^Xm
Md^Xm, Md^Xm, Md^Xm, Md^Xm, Hd, Dd^Vdt, Gd, Hhd, Md, Md^Xm, Md^Xm, Md^Xm, Md^Xm, Md^Xm, Hhd, Hd, Gd, Hd, Hd, Md, Md^Xm, Md^Xm
Md^Xm, Md^Xm, Md, Hd, Gs, Gd, Hd, Hhd, Md^Xm, Md^Xm, Md^Xm, Md^Xm, Md, Hhd, Hd, Hd, Hd, Gd, Hd, Hhd, Md, Md
Md^Xm, Md^Xm, Md, Hd, Gg, Gd, Hd, Md, Md^Xm, Md^Xm, Md^Xm, Md^Xm, Md, Hhd, Hd, Hd, Hd, Gs, Hd, Hd, Hhd, Hhd
