Xu, Xu, Xu, Xu, Xu, Xu, Xu, Xu, Xu, Xu, Xu, Xu, Xu, Xu, Xu, Xu, Xu, Xu, Xu, Xu, Xu, Xu, Xu, Xu, Xu, Xu, Xu, Xu, Xu, Xu, Xu, Xu, Xu, Hh, Hh, Mm, Mm, Mm
Xu, Xu, Xu, Xu, Xu, Xu, Xu, Xu, Xu, Xu, Xu, Xu, Xu, Xu, Xu, Xu, Xu, Xu, Xu, Xu, Xu, Xu, Uu, Uu, Uu, Xu, Uu, Xu, Uu, Xu, Uu, Xu, Uu, Mm, Mm, Mm, Hh^Vhh, Mm
Xu, Xu, Ur, Ur, Ur, Xu, Xu, Xu, Xu, Xu, Xu, Xu, Xu, Xu, Xu, Xu, Xu, Xu, Xu, Xu, Uu, Uu, Xu, Uu^Vu, Xu, Uu, Uu^Vu, Uu, Uu^Vu, Uu, Uu^Vu, Uu, Uu, Mm, Hh, Ce, Ce, Ce
Xu, Xu, Ur^Vu, Ur, Ur, Xu, Xu, Xu, Xu, Xu, Xu, Xu, Cud, Xu, Ur, Ur, Cud, 3 Kud, Cud, Ur, Ur, Cud, Cud, Xu, Xu, Xu, Xu, Xu, Xu, Xu, Xu, Xu, Xu, Hh, Ce, Ce, 2 Ke, Ce
Xu, Xu, Xu, Ur, Ur, Xu, Xu, Xu, Xu, Xu, Xu, Xu, Cud, Ur, Ur, Cud, Cud, Cud, Cud, Cud, Ur, Ur, Cud, Xu, Xu, Xu, Xu, Xu, Xu, Xu, Xu, Xu, Xu, Hh, Hh^Vhh, Ce, Ce, Ce
Xu, Xu, Xu, Xu, Ur, Xu, Xu, Xu, Xu, Xu, Xu, Xu, Ur, Ur, Ur, Ur, Ur, Cud, Ur, Ur, Ur, Ur, Cud, Xu, Xu, Xu, Xu, Xu, Xu, Xu, Xu, Xu, Xu, Mm, Mm, Mm, Hh, Hh
Xu, Ur^Vu, Ur, Ur, Ur, Xu, Xu, Xu, Xu, Xu, Ur, Ur, Ur, Ur, Cud, Ur, Ur, Ur, Ur, Ur, Ur, Cud, Cud, Xu, Xu, Xu, Xu, Xu, Xu, Xu, Xu, Xu, Xu, Mm, Mm, Mm, Mm, Hh
Xu, Ur, Ur, Ur, Ur, Xu, Xu, Xu, Ur^Vud, Ur, Ur, Ur, Xu, Cud, Cud, Ur, Ur, Ur, Ur, Ur, Ur, Ur, Ur, Xu, Ur, Xu, Xu, Xu, Xu, Xu, Xu, Xu, Ur, Mm, Mm, Mm, Mm, Mm
Xu, Ur^Vu, Xu, Ur, Ur, Xu, Xu, Xu, Ur, Ur, Xu, Xu, Xu, Xu, Xu, Cud, Cud, Ur, Cud, Cud, Cud, Ur, Ur, Ur, Ur, Ur, Ur, Xu, Cud, Xu, Ur, Ur, Ur, Rd, Rd, Mm, Mm, Mm
Xu, Xu, Xu, Xu, Ur, Xu, Xu, Xu, Ur, Ur, Xu, Xu, Xu, Xu, Xu, Xu, Xu, Cud, Xu, Xu, Xu, Xu, Xu, Ur, Xu, Ur, Ur, Ur, Ur, Ur, Ur, Ur, Xu, Mm, Hh, Rd, Rd, Mm
Xu, Xu, Xu, Xu, Cud, Xu, Xu, Xu, Ur, Ur, Xu, Xu, Xu, Xu, Xu, Xu, Xu, Xu, Xu, Xu, Xu, Xu, Xu, Xu, Xu, Xu, Cud, Ur, Ur, Ur, Cud, Xu, Xu, Hh, Mm, Hh, Hh, Rd
Xu, Xu, Cud, 1 Kud, Cud, Cud, Ur, Ur, Ur, Ur^Vu, Xu, Xu, Xu, Xu, Xu, Xu, Xu, Xu, Xu, Xu, Xu, Xu, Xu, Xu, Xu, Xu, Xu, Cud, Ur, Ur, Xu, Xu, Xu, Mm, Mm, Mm, Mm, Hh
Xu, Xu, Cud, Cud, Ur, Ur, Ur, Ur, Xu, Xu, Xu, Xu, Xu, Xu, Xu, Xu, Xu, Xu, Xu, Xu, Xu, Xu, Xu, Xu, Xu, Xu, Xu, Xu, Ur, Ur^Vu, Xu, Xu, Xu, Hh, Hh, Mm, Mm, Mm
Ur, Ur, Ur, Ur, Ur, Ur, Cud, Xu, Xu, Xu, Ur, Xu, Xu, Xu, Ur, Xu, Xu, Xu, Ur, Xu, Xu, Xu, Xu, Xu, Ur, Xu, Xu, Xu, Ur, Ur, Xu, Xu, Xu, Hh, Mm, Mm, Mm, Hh
Ur, Ur, Ur, Ur, Ur, Ur, Ur, Ur, Ur, Ur, Ur, Ur, Ur, Ur, Ur, Ur, Ur, Ur, Ur, Ur, Ur, Ur^Vu, Ur, Ur, Ur, Ur, Ur, Ur, Ur, Ur, Xu, Xu, Xu, Mm, Mm, Mm, Mm, Mm
Xu, Cud, Xu, Cud, Xu, Ur, Ur, Ur, Ur, Ur, Ur, Ur, Ur^Vu, Ur, Ur, Ur, Ur, Ur, Ur, Ur, Ur, Ur, Ur, Ur, Ur, Ur, Ur, Ur, Xu, Xu, Xu, Xu, Xu, Mm, Mm, Mm, Mm, Mm
Xu, Xu, Xu, Xu, Xu, Xu, Xu, Xu, Xu, Ur, Xu, Xu, Xu, Xu, Xu, Ur, Xu, Xu, Xu, Xu, Xu, Ur, Xu, Xu, Xu, Xu, Xu, Xu, Xu, Xu, Xu, Xu, Xu, Mm, Hh, Mm, Mm, Hh
Xu, Xu, Xu, Xu, Xu, Xu, Xu, Xu, Xu, Xu, Xu, Xu, Xu, Xu, Xu, Xu, Xu, Xu, Xu, Xu, Xu, Xu, Xu, Xu, Xu, Xu, Xu, Xu, Xu, Xu, Xu, Xu, Xu, Hh, Mm, Mm, Mm, Hh
Xu, Xu, Xu, Xu, Xu, Xu, Xu, Xu, Xu, Xu, Xu, Xu, Xu, Xu, Xu, Xu, Xu, Xu, Xu, Xu, Xu, Xu, Xu, Xu, Xu, Xu, Xu, Xu, Xu, Xu, Xu, Xu, Xu, Hh, Mm, Mm, Mm, Hh
Xu, Xu, Xu, Xu, Xu, Xu, Xu, Xu, Xu, Xu, Xu, Xu, Xu, Xu, Xu, Xu, Xu, Xu, Xu, Xu, Xu, Xu, Xu, Xu, Xu, Xu, Xu, Xu, Xu, Xu, Xu, Xu, Xu, Hh, Hh, Mm, Mm, Mm
