Xu, Xu, Cud, Xu, Xu, Xos, Xos, Xos, Xos, Xos, Xos, Xos, Xos, Xos, Xos, Xos, Xos, Xos, Xos, Xos, Xos, Xos, Xos, Xos, Xos, Xos, Xos, Xos, Xos, Xos, Xos, Xos
Xu, Cud, 1 Kud, Cud, Xu, Xos, Xos, Xos, Ur, Xos, Ur, Xos, Ur, Xos, Xos, Xos, Xos, Xos, Xos, Xos, Xos, Xos, Xos, Xos, Xos, Xos, Xos, Xos, Xos, Xos, Xos, Xos
Cud, Cud, Cud, Cud, Xu, Xos, Xos, Xos, Xos, Ur, Xos, Ur, Xos, Ur, Ur, Xos, Xos, Xos, Ur^Vud, Xos, Ur, Xos, Ur^Vud, Xos, Xos, Xos, Xos, Xos, Xos, Xos, Xos, Xos
Ur, Cud, Ur, Xu, Xos, Xos, Xos, Xos, Ur, Xos, Xos, Xos, Xos, Xos, Ur, Ur, Ur, Ur, Ur, Ur, Ur, Ur, Ur, Ur, Ur, Cud, Kud, Xos, Ur, Xos, Xos, Xos
Ur, Ur, Ur, Ur, Ur, Xos, Xos, Ur, Ur, Xos, Xos, Xos, Ur, Ur, Ur, Ur, Ur^Vud, Ur, Xos, Ur, Xos, Ur, Xos, Ur, Ur, Cud, Cud, Cud, Xos, Ur, Ur, Xos
Xu, Ur, Ur, Ur, Ur, Ur^Vud, Xos, Xos, Xos, Ur, Ur, Ur, Ur, Ur, Ur, Xos, Xos, Xos, Xos, Xos, Xos, Xos, Xos, Ur, Ur, Ur, Ur^Vud, Xos, Xos, Xos, Ur, Xos
Xos, Xu, Xos, Ur, Ur, Ur, Ur, Xos, Ur, Ur, Ur, Ur, Xos, Xos, Xos, Ur, Ur, Xos, Xos, Xos, Ur, Xos, Xos, Xos, Xos, Ur, Ur, Ur, Xos, Xos, Ur, Xos
Xos, Xos, Xos, Ur, Ur, Ur, Ur, Ur, Ur, Ur, Xos, Xos, Xos, Xos, Ur, Ur, Xos, Xos, Ur, Ur, Ur, Xos, Xos, Xos, Xos, Xos, Ur, Ur, Xos, Xos, Ur, Xos
Xos, Xos, Xos, Ur, Ur, Ur, Ur, Ur, Ur, Xos, Xos, Xos, Xos, Xos, Xos, Xos, Ur, Ur, Ur, Ur, Ur, Xos, Xos, Xos, Xos, Xos, Xos, Xos, Xos, Xos, Ur, Xos
Xos, Xos, Xos, Ur, Ur, Ur, Ur^Vud, Ur, Ur, Ur, Xos, Xos, Ur^Vud, Xos, Xos, Ur, Ur, Ur, Ur, Ur, Xos, Xos, Xos, Xos, Xos, Xos, Xos, Xos, Xos, Xos, Ur, Xos
Xos, Xos, Xos, Ur, Ur, Xos, Xos, Xos, Ur, Ur, Ur, Ur, Ur, Ur, Ur, Xos, Ur, Ur, Xos, Xos, Xos, Xos, Xos, Xos, Xos, Xos, Cud, Xos, Xos, Xos, Ur, Xos
Xos, Xos, Xos, Ur, Ur, Xos, Xos, Xos, Xos, Ur, Ur, Ur, Ur, Ur, Ur, Ur, Ur, Xos, Ur^Vud, Xos, Xos, Xos, Xos, Xos, Cud, Cud, Ur, Cud, Xos, Xos, Ur, Xos
Xos, Xos, Xos, Ur, Ur, Xos, Xos, Xos, Xos, Xos, Xos, Xos, Xos, Ur, Ur, Ur, Ur, Ur, Ur, Ur, Ur, Xos, Ur, Cud, Ur, Ur, Ur, Cud, Xos, Xos, Ur, Xos
Xos, Xos, Xos, Ur, Ur, Ur, Ur, Xos, Xos, Xos, Xos, Xos, Xos, Xos, Xos, Ur, Ur, Ur, Ur, Ur, Ur, Ur, Ur, Ur, Ur, Ur, Ur, 2 Kud, Xos, Xos, Ur, Xos
Xos, Xos, Xos, Ur^Vud, Ur, Ur, Ur, Ur, Ur, Ur^Vud, Ur, Xos, Ur, Xos, Ur, Xos, Ur, Ur, Ur, Ur, Ur, Ur, Ur, Ur, Ur, Ur, Ur, Cud, Xos, Xos, Ur, Xos
Xos, Xos, Xos, Xos, Xos, Ur, Ur, Ur, Ur, Ur, Ur, Ur, Ur, Ur, Ur, Ur, Ur, Ur, Ur, Ur, Ur, Xos, Xos, Cud, Cud, Ur, Cud, Cud, Ur^Vud, Xos, Xos, Xos
Xos, Xos, Xos, Xos, Xos, Xos, Xos, Ur, Ur, Ur, Ur^Vud, Ur, Ur, Ur, Ur^Vud, Ur, Ur, Ur, Ur, Ur^Vud, Xos, Xos, Xos, Xos, Xos, Cud, Xos, Xos, Xos, Xos, Xos, Xos
Xu, Xos, Xos, Xos, Xos, Xos, Xos, Xos, Xos, Xos, Xos, Xos, Xos, Xos, Xos, Xos, Xos, Xos, Xos, Xos, Xos, Xos, Xos, Xos, Xos, Xos, Xos, Xos, Xos, Xos, Xos, Xos
