Md^Xm, Md^Xm, Md^Xm, Md^Xm, Md^Xm, Md^Xm, Md^Xm, Md, Md, Md, Md, Md, Md, Md, Md, Md, Md, Mm^Xm, Mm^Xm, Mm^Xm, Mm^Xm, Mm^Xm
Md^Xm, Md^Xm, Md^Xm, Md^Xm, Md^Xm, Md^Xm, Md, Md, Md, Md, Hd, Hd, Hd, Ce, Ce, Md, Md, Md, Md^Xm, Md^Xm, Md^Xm, Mm^Xm
Md^Xm, Md^Xm, Md^Xm, Md^Xm, Md, Md, Dd^Do, Dd^Vdt, Hd, Hd, Hd, Hd, Hd, Hd, Hd, Ke, Ce, Md, Md, Md^Xm, Md^Xm, Md^Xm
Md^Xm, Md^Xm, Md^Xm, Md, Md, Md, Md, Hd, Md, Md, Md, Dd^Vda, Md, Md, Hd, Dd^Do, Ce, Md, Md, Md, Md^Xm, Md^Xm
Md^Xm, Md^Xm, Md, Md, Md, Md, Hd, Md, Md, Md, Md, Md, Md, Md, Md, Hd, Hd, Md, Md, Md, Md^Xm, Md^Xm
Md^Xm, Md^Xm, Md, Md, Hd, Hd, Md, Md, Dd^Vdt, Md, Md, Md, Md^Xm, Md, Md, Hd, Hd, Md, Md, Md, Md^Xm, Md^Xm
Md^Xm, Md^Xm, Md, Md, Hd, Md, Hd, Hd, Md, Md, Md^Xm, Md^Xm, Md^Xm, Md^Xm, Md, Hd, Hd, Md, Md, Md^Xm, Md^Xm, Md^Xm
Md^Xm, Md^Xm, Md, Hd, Gg, Md, Hd, Md, Md, Md, Md^Xm, Md^Xm, Md, Md, Md, Dd^Vdt, Hd, Gg, Md, Md^Xm, Md^Xm, Md^Xm
Md^Xm, Md^Xm, Md, Gg, Hd, Md, Md, Hd, Md, Md, Md^Xm, Md^Xm, Md, Md, Md, Md, Hd, Gg, Md, Md, Md^Xm, Md^Xm
Md^Xm, Md^Xm, Md, Dd^Vda, Hd, Md, Md, Hd, Md, Md, Md^Xm, Md^Xm, Md^Xm, Md, Md, Md, Hd, Gg, Md, Md, Md^Xm, Md^Xm
Md^Xm, Md^Xm, Md^Xm, Md, Md, Hd, Md, Hd, Gg, Md, Md^Xm, Md^Xm, Md^Xm, Md, Md, Hd, Hd, Gg, Md, Md, Md^Xm, Md^Xm
Md^Xm, Md^Xm, Md^Xm, Md, Md, Gg, Gg, Hd, Dd^Vdt, Md, Md, Md^Xm, Md^Xm, Md, Md, Hd, Hd, Dd^Vdt, Md, Md, Md^Xm, Md^Xm
Md^Xm, Md^Xm, Md, Md, Chr, Gg, Gg, Hd, Hd, Md, Md, Md^Xm, Md^Xm, Md^Xm, Md, Hd, Hd, Hd, Md, Md, Md^Xm, Md^Xm
Md^Xm, Md, Chr, Chr, Chr, Gg, Gg, Hd, Hd, Md, Md, Md^Xm, Md^Xm, Md^Xm, Md, Hd, Md, Md, Md, Md, Md^Xm, Md^Xm
Md^Xm, Md, Chr, 2 Khr, Chr, Gg, Gg, Hd, Md, Md, Md, Md^Xm, Md^Xm, Md^Xm, Md, Dd^Vda, Gg, Md, Md, Md^Xm, Md^Xm, Md^Xm
Md^Xm, Md, Chr, Chr, Md, Gg, Gg, Dd^Vda, Md, Md, Md^Xm, Md^Xm, Md^Xm, Md, Md, Gg, Gg, Md, Md^Xm, Md^Xm, Md^Xm, Md^Xm
Md^Xm, Md, Md, Chr, Md, Md, Gg, Gg, Md, Md, Md^Xm, Md^Xm, Md^Xm, Md, Md, Gg, Gg, Md, Md^Xm, Md^Xm, Md^Xm, Md^Xm
Md^Xm, Md^Xm, Md^Xm, Md, Md, Hd, Gg, Gg, Md, Md, Md^Xm, Md^Xm, Md^Xm, Md, Md, Gg, 1 Gg, Md, Md, Md^Xm, Md^Xm, Md^Xm
Md^Xm, Md^Xm, Md^Xm, Md^Xm, Md, Hd, Gg, Gg, Md, Md, Md^Xm, Md^Xm, Md^Xm, Md, Md, Hd, Gg, Hd, Md, Md^Xm, Md^Xm, Md^Xm
Md^Xm, Md^Xm, Md^Xm, Md^Xm, Hd, Dd^Vdt, Gg, Md, Md, Md^Xm, Md^Xm, Md^Xm, Md^Xm, Md^Xm, Md, Hd, Gg, Hd, Hd, Md, Md^Xm, Md^Xm
Md^Xm, Md^Xm, Md, Hd, Gg, Gg, Hd, Md, Md^Xm, Md^Xm, Md^Xm, Md^Xm, Md, Md, Hd, Hd, Hd, Gg, Hd, Md, Md, Md
Md^Xm, Md^Xm, Md, Hd, Gg, Gg, Hd, Md, Md^Xm, Md^Xm, Md^Xm, Md^Xm, Md, Md, Hd, Hd, Hd, Gg, Hd, Hd, Md, Md
