Wwg, Wog, Wwg, Wog, Wwg, Wog, Wwg, Wwg, Wwg, Wwg, Wwrg, Wwg, Hhd, Hhd, Hhd, Md^Xm, Md^Xm, Md^Xm, Md^Xm, Md^Xm, Md^Xm, Md^Xm, Md, Md^Xm, Md, Md^Xm, Md^Xm, Md^Xm, Md^Xm, Md^Xm, Md^Xm, Md^Xm, Md^Xm, Md^Xm, Md^Xm, Md^Xm, Md^Xm, Md^Xm, Md^Xm, Md^Xm, Md^Xm, Md^Xm
Wwg, Wwg, Wwg, Wwg, Wwg, Wwg, Wwg, Wwg, Wwrg, Wwrg, Hhd, Hhd, Hhd, Hhd, Hhd, Md, Md, Md, Md, Md, Md, Md, Md, Md, Md, Md, Md, Md, Md, Md, Md, Md^Xm, Md^Xm, Md^Xm, Md^Xm, Md^Xm, Md^Xm, Md^Xm, Md^Xm, Md^Xm, Md^Xm, Md^Xm
Wwg, Wwg, Wwg, Wwg, Wwg, Wwg, Wwg, Wwrg, Hhd, Hhd, Ch, Hhd, Hhd, Hhd, Hhd, Hhd, Hhd^Fdw, Hhd^Fdw, Hhd, Hhd, Hhd, Hhd^Fdw, Hhd, Hhd, Hhd, Hhd, Hhd, Gd^Vhr, Hhd^Fdw, Md, Md, Md, Md, Md^Xm, Md^Xm, Md^Xm, Md^Xm, Md^Xm, Md^Xm, Md^Xm, Md^Xm, Md^Xm
Wwg, Wwg, Wwg, Wwg, Wwg, Wwg, Wwrg, Wwrg, Hhd, Ch, Hhd, Hhd, Hhd, Hhd, Hhd, Hhd, Hhd, Hhd, Hhd, Hhd, Hhd, Hhd, Hhd, Hhd, Hhd^Fdw, Hhd^Fdw, Hhd, Hhd, Hhd, Hhd^Fdw, Hhd, Md, Md, Md, Md, Md^Xm, Md^Xm, Md^Xm, Md^Xm, Md^Xm, Md^Xm, Md^Xm
Wwg, Wwg, Wwg, Wwg, Wwrg, Wwrg, Hhd, Hhd, Hhd, Ch, Hhd, Hhd, Hhd, Hhd, Hhd, Hhd, Hhd, Hhd, Ch, Ch, Ch, Hhd, Hhd, Gd^Vhr, Hhd^Fdw, Hhd^Fdw, Hhd, Hhd, Hhd, Hhd, Hhd, Hhd, Hhd, Md, Md, Md, Md^Xm, Md^Xm, Md^Xm, Md^Xm, Md^Xm, Md^Xm
Wwg, Wwg, Wwg, Wwrg, Hhd, Hhd, Ch, Hhd, Hhd, Hhd, Hhd, Hhd, Hhd, Hhd, Hhd, Hhd^Vhhr, Hhd, Hhd, Ch, 2 Kh, Ch, Hhd, Hhd, Hhd, Chr, Hhd, Chr, Hhd, Chr, Hhd^Vhhr, Hhd^Fdw, Hhd, Hhd, Hhd, Hhd^Vhhr, Md, Md^Xm, Md^Xm, Md^Xm, Md^Xm, Md^Xm, Md^Xm
Wog, Wwg, Wwg, Wwrg, Hhd, Hhd, Ch, Hhd, Hhd, Hhd, Hhd, Hhd, Hhd, Hhd, Hhd, Hhd, Hhd, Hhd, Ch, Ch, Ch, Hhd, Hhd, Hhd, Hhd, Chr, Hhd, Chr, Hhd, Hhd^Fdw, Hhd, Hhd, Hhd, Hhd^Fdw, Hhd^Fdw, Md, Md, Md^Xm, Md^Xm, Md^Xm, Md^Xm, Md^Xm
Wog, Wog, Wwg, Wwrg, Hhd, Ch, Hhd, Hhd, Hhd, Hhd^Vhhr, Hhd, Hhd, Hhd, Hhd, Hhd, Hhd, Hhd^Fdw, Hhd, Hhd, Ch, Hhd, Hhd, Hhd, Hhd, Wwrg, Hhd, Hhd, Hhd, Hhd, Hhd, Hhd, Hhd, Hhd, Hhd, Hhd^Fdw, Md, Md, Md^Xm, Md^Xm, Md^Xm, Md^Xm, Md^Xm
Wog, Wog, Wwg, Wwrg, Hhd, Hhd, Hhd, Hhd, Hhd, Hhd, Hhd, Hhd, Hhd, Hhd, Wwrg, Hhd, Hhd, Hhd, Hhd, Hhd, Hhd, Hhd, Wwrg, Wwrg, Wog, Wwrg, Wwrg, Hhd, Ww^Vm, Hhd, Hhd, Hhd, Wwrg, Hhd, Hhd, Hhd, Md, Md^Xm, Md^Xm, Md^Xm, Md^Xm, Md^Xm
Wog, Wog, Wwg, Wwrg, Hhd, Hhd, Hhd, Hhd, Hhd, Hhd, Hhd, Hhd, Hhd, Wwrg, Wog, Wwrg, Wwrg, Wwrg, Wwrg, Hhd, Wwrg, Wwrg, Wog, Wog, Wog, Wog, Wog, Wwrg, Wwrg, Hhd, Wwrg, Hhd, Wwrg, Wwrg, Hhd, Hhd^Vhhr, Hhd^Fdw, Md, Md^Xm, Md^Xm, Md^Xm, Md^Xm
Wog, Wog, Wwg, Wwrg, Hhd, Ch, Ch, Hhd, Hhd, Hhd, Hhd, Hhd, Wwrg, Wwrg, Wog, Wog, Wog, Wog, Wwrg, Wwrg, Wog, Wog, Wog, Wog, Wog, Wog, Wog, Wog, Wwrg, Hhd, Wwrg, Hhd, Wwrg, Wwrg, Hhd, Hhd^Fdw, Hhd, Md, Md^Xm, Md^Xm, Md^Xm, Md^Xm
Wog, Wog, Wwg, Wwrg, Wwrg, Hhd, Ch, Hhd, Hhd, Hhd, Hhd, Hhd, Wwrg, Wog, Wog, Wog, Wog, Wog, Wwrg, Wwrg, Wog, Wog, Wog, Wog, Wog, Wog, Wwrg, Wog, Wwrg, Hhd, Hhd, Hhd, Hhd, Hhd, Hhd, Wwrg, Hhd, Md, Md^Xm, Md^Xm, Md^Xm, Md^Xm
Wog, Wog, Wog, Wwg, Wwrg, Hhd, Hhd, Hhd, Hhd, Hhd, Wwrg, Wwrg, Wog, Wog, Wog, Wog, Wog, Wwrg, Ww^Vm, Wwrg, Wog, Wog, Wog, Wog, Wog, Wwrg, Ww^Vm, Wwrg, Hhd, Hhd, Hhd, Wwrg, Hhd, Wwrg, Hhd, Wwrg, Wwrg, Hhd, Md^Xm, Md^Xm, Md^Xm, Md^Xm
Wog, Ww^Vm, Wog, Wwg, Wwg, Wwrg, Hhd, Hhd, Hhd, Hhd, Wwrg, Wog, Wog, Wog, Wog, Wog, Wog, Wwrg, Wwrg, Wwrg, Wog, Wog, Wog, Wog, Wog, Wwrg, Wwrg, Hhd, Hhd, Wwrg, Hhd, Hhd, Hhd, Wwrg, Wwrg, Hhd, Hhd, Hhd, Hhd, Md^Xm, Md^Xm, Md^Xm
Wog, Wog, Wog, Wog, Wog, Wwg, Hhd, Hhd, Wwrg, Wwrg, Wog, Wog, Wwrg, Wwrg, Wwrg, Wog, Wog, Wog, Wog, Wog, Wog, Wog, Wog, Wog, Wog, Wog, Wog, Hhd, Chw, Wog, Wog, Hhd, Hhd, Hhd, Hhd, Hhd, Wwrg, Hhd, Hhd, Md^Xm, Md^Xm, Md^Xm
Wog, Wog, Wog, Wog, Ww^Vm, Wog, Hhd, Hhd, Chw, Wog, Wog, Wog, Wwrg, Ww^Vm, Wwrg, Wog, Wog, Wog, Wog, Wog, Wog, Wog, Wog, Wog, Wog, Wog, Wog, Chw, 3 Khw, Chw, Hhd, Wwrg, Wwrg, Hhd, Ww^Vm, Hhd, Hhd, Wwrg, Hhd, Md^Xm, Md^Xm, Md^Xm
Wog, Wog, Wog, Wog, Wog, Wog, Wog, Chw, 4 Khw, Chw, Wog, Wog, Wwrg, Wwrg, Wog, Wog, Wog, Wog, Wog, Wog, Wwrg, Wog, Wog, Wog, Wog, Wog, Wog, Chw, Chw, Chw, Wwrg, Hhd, Wwrg, Hhd, Hhd, Hhd, Wwrg, Hhd, Hhd, Md^Xm, Md^Xm, Md^Xm
Wog, Wog, Wog, Wog, Wog, Wog, Wog, Chw, Chr, Chr, Wog, Wog, Wwrg, Wwrg, Wog, Wog, Wog, Wog, Wog, Wwrg, Ww^Vm, Wwrg, Wwrg, Wog, Wog, Wog, Wog, Chw, Chw, Chw, Wwrg, Hhd, Hhd, Hhd, Hhd, Hhd, Wwrg, Hhd, Hhd, Md^Xm, Md^Xm, Md^Xm
Wog, Wog, Wog, Wog, Wog, Wog, Wog, Wog, Hhd, Wwrg, Wwrg, Wwrg, Ww^Vm, Wwrg, Wog, Wog, Wog, Wog, Wog, Wwrg, Wwrg, Wwrg, Wwrg, Wog, Wog, Wog, Wog, Wog, Wwrg, Hhd, Wwrg, Hhd, Wwrg, Wwrg, Hhd, Hhd, Wwrg, Hhd, Hhd, Md^Xm, Md^Xm, Md^Xm
Wog, Wog, Ww^Vm, Wog, Wog, Wog, Wog, Wog, Hhd, Wwrg, Wwrg, Wwrg, Wwrg, Wwrg, Wog, Wog, Wog, Wog, Wog, Wog, Wwrg, Wwrg, Wwrg, Wog, Wog, Wog, Wwrg, Wwrg, Wwrg, Hhd, Hhd, Hhd, Hhd, Hhd, Ww^Vm, Hhd, Hhd, Hhd, Hhd, Md^Xm, Md^Xm, Md^Xm
Wog, Wog, Wog, Wog, Wwrg, Wwrg, Wwrg, Wog, Hhd, Wwrg, Wog, Wog, Wog, Wog, Wog, Wog, Wog, Wog, Wog, Wog, Wwrg, Wwrg, Ww^Vm, Wwrg, Wog, Wog, Wwrg, Ww^Vm, Hhd, Hhd, Wwrg, Wwrg, Hhd, Hhd, Wog, Hhd, Hhd, Wwrg, Hhd, Md^Xm, Md^Xm, Md^Xm
Wog, Wog, Wwrg, Wwrg, Hhd, Hhd, Hhd, Hhd, Hhd, Wwrg, Wwrg, Wog, Wog, Wog, Wwrg, Wog, Wwrg, Wog, Wog, Wog, Wog, Wwrg, Wwrg, Wwrg, Wog, Wog, Wog, Wwrg, Hhd, Wwrg, Hhd, Hhd, Wwrg, Hhd, Hhd, Wwrg, Hhd, Wwrg, Hhd, Md^Xm, Md^Xm, Md^Xm
Wog, Wog, Wwrg, Hhd, Hhd, Hhd, Hhd, Hhd, Hhd, Hhd, Hhd, Hhd, Hhd, Wwrg, Wwrg, Wwrg, Hhd, Wwrg, Wwrg, Wog, Wog, Wog, Wog, Wog, Wog, Wog, Wog, Wwrg, Wwrg, Hhd, Hhd, Wwrg, Hhd, Hhd, Hhd, Hhd, Hhd, Hhd, Md^Xm, Md^Xm, Md^Xm, Md^Xm
Wog, Wog, Wwrg, Hhd, Hhd, Hhd^Vhhr, Hhd^Fdw, Hhd, Hhd^Fdw, Hhd, Hhd, Hhd, Hhd, Hhd, Hhd, Hhd, Hhd, Hhd, Hhd, Wwrg, Wwrg, Wog, Wog, Wog, Wwrg, Wwrg, Wwrg, Wwrg, Hhd, Hhd, Wwrg, Wwrg, Hhd, Wwrg, Wwrg, Hhd, Hhd, Hhd, Md^Xm, Md^Xm, Md^Xm, Md^Xm
Wog, Wog, Wwrg, Wwrg, Hhd, Hhd, Hhd^Fdw, Hhd^Fdw, Hhd, Hhd^Fdw, Hhd^Fdw, Hhd^Fdw, Hhd, Hhd, Hhd, Hhd, Hhd^Fdw, Hhd, Hhd, Hhd, Hhd, Wwrg, Wwrg, Wog, Wwrg, Ww^Vm, Hhd, Hhd, Wwrg, Wwrg, Hhd, Hhd, Hhd, Hhd, Hhd, Hhd, Hhd, Md, Md^Xm, Md^Xm, Md^Xm, Md^Xm
Wog, Wog, Wwrg, Wwrg, Hhd, Hhd, Hhd, Hhd^Fdw, Gd^Vhr, Hhd, Hhd, Hhd, Cdr, Hhd, Hhd, Hhd^Fdw, Hhd^Fdw, Hhd^Fdw, Hhd^Fdw, Hhd, Hhd, Hhd, Hhd, Wwrg, Hhd, Hhd, Hhd, Hhd, Hhd, Hhd, Hhd, Hhd, Hhd, Hhd, Gs^Vh, Hhd^Fdw, Hhd, Md, Md^Xm, Md^Xm, Md^Xm, Md^Xm
Wog, Wog, Wog, Wwrg, Wwrg, Hhd, Hhd, Hhd, Hhd, Hhd, Cdr, Cdr, 1 Kdr, Cdr, Cdr, Hhd, Hhd^Fdw, Hhd^Fdw, Hhd^Vhhr, Hhd^Fdw, Hhd^Fdw, Hhd, Hhd, Hhd, Hhd, Hhd, Hhd, Hhd, Hhd, Hhd, Hhd^Fdw, Hhd, Hhd^Fdw, Hhd^Fdw, Hhd^Fdw, Hhd^Fdw, Md, Md, Md^Xm, Md^Xm, Md^Xm, Md^Xm
Wog, Wog, Wog, Wog, Wog, Wwrg, Wwrg, Hhd, Hhd, Hhd, Hhd, Cdr, Cdr, Cdr, Hhd, Hhd, Hhd^Fdw, Hhd^Fdw, Hhd^Fdw, Hhd^Fdw, Hhd^Fdw, Hhd^Fdw, Hhd^Fdw, Hhd, Hhd^Vhhr, Hhd^Fdw, Hhd^Fdw, Hhd^Fdw, Hhd^Fdw, Hhd^Fdw, Hhd^Vhhr, Hhd^Fdw, Hhd^Fdw, Hhd^Fdw, Hhd^Fdw, Hhd^Fdw, Md, Md, Md^Xm, Md^Xm, Md^Xm, Md^Xm
Wog, Wog, Wog, Wog, Wog, Wwrg, Wwrg, Wwrg, Hhd, Hhd, Hhd, Hhd, Hhd, Hhd, Hhd^Fdw, Hhd^Fdw, Hhd^Fdw, Hhd^Fdw, Hhd^Fdw, Hhd^Fdw, Hhd^Fdw, Hhd^Fdw, Hhd^Fdw, Hhd^Fdw, Hhd^Fdw, Hhd^Fdw, Hhd^Fdw, Hhd^Fdw, Hhd^Fdw, Hhd^Fdw, Hhd^Fdw, Hhd^Fdw, Hhd^Fdw, Hhd^Fdw, Md, Md, Md^Xm, Md^Xm, Md^Xm, Md^Xm, Md^Xm, Md^Xm
Wog, Wog, Wog, Wog, Wog, Wog, Wog, Wwrg, Wwrg, Hhd, Hhd, Hhd, Hhd, Hhd^Fdw, Hhd^Vhhr, Hhd^Fdw, Hhd^Fdw, Hhd^Fdw, Hhd^Fdw, Gd^Vhr, Hhd^Fdw, Hhd^Fdw, Hhd^Fdw, Hhd^Fdw, Hhd^Fdw, Hhd^Fdw, Md, Hhd^Fdw, Hhd^Fdw, Md, Md, Md, Md, Md, Md^Xm, Md^Xm, Md^Xm, Md^Xm, Md^Xm, Md^Xm, Md^Xm, Md^Xm
Wog, Wog, Wog, Wog, Wog, Wog, Wog, Wog, Wog, Wwrg, Wwrg, Hhd, Hhd, Hhd^Fdw, Hhd^Fdw, Hhd^Fdw, Hhd^Fdw, Md, Md, Md, Md, Md, Md, Md, Md, Md, Md^Xm, Md, Md, Md, Md^Xm, Md^Xm, Md^Xm, Md^Xm, Md^Xm, Md^Xm, Md^Xm, Md^Xm, Md^Xm, Md^Xm, Md^Xm, Md^Xm
Wog, Wog, Wog, Wog, Wog, Wog, Wog, Wog, Wog, Wwrg, Wog, Hhd, Wwrg, Hhd, Hhd^Fdw, Hhd^Fdw, Hhd^Fdw, Md^Xm, Md^Xm, Md^Xm, Md^Xm, Md^Xm, Md^Xm, Md^Xm, Md^Xm, Md^Xm, Md^Xm, Md^Xm, Md^Xm, Md^Xm, Md^Xm, Md^Xm, Md^Xm, Md^Xm, Md^Xm, Md^Xm, Md^Xm, Md^Xm, Md^Xm, Md^Xm, Md^Xm, Md^Xm
