Gs^Fds, Gs^Fds, Gs^Fds, Gs^Fds, Gs^Fds, Gs^Fds, Gs^Fds, Gs^Fds, Gs^Fds, Gg, Gg, Gg, Gg, Rd, Rd, Gs^Fds, Gs^Fds, Gs^Fds, Hh^Fds, Mm, Mm, Mm, Mm, Mm, Mm, Mm, Mm, Mm, Hh^Fds, Gs^Fds, Gs^Fds, Gs^Fds, Gg, Gg, Rd, Rd, Gg, Gg, Gg, Gg, Gg, Gg, Gg, Gg, Gg, Gg
Gs^Fds, Gs^Fds, Gs^Fds, Gs^Fds, Gs^Fds, Gs^Fds, Rd, Gs^Fds, Gg, Gg, Gg, Gg, Gg, Rd, Rd, Gg, Gg, Gs^Fds, Gs^Fds, Hh^Fds, Hh^Fds, Mm, Mm, Hh^Vhh, Hh^Fds, Mm, Hh^Fds, Hh^Fds, Gs^Fds, Gs^Fds, Gs^Fds, Gs^Fds, Gg, Gg, Rd, Rd, Gg, Gg^Vh, Gg, Gg, Gs^Fds, Gg, Gg, Gg, Gg, Gg
Gs^Fds, Gs^Fds, Gs^Fds, Gs^Fds, Rd, Rd, Gg, Gg, Ch, Ch, Ch, Gg, Gg, Rd, Rd, Gg, Gg, Gg, Gs^Vh, Gs^Fds, Gs^Fds, Hh^Fds, Hh^Fds, Hh^Fds, Hh^Fds, Hh^Fds, Gs^Fds, Gs^Fds, Gs^Fds, Gs^Fds, Gs^Fds, Gs^Fds, Gs^Fds, Gg, Rd, Rd, Gg, Gg, Gs^Fds, Gs^Fds, Gs^Fds, Gg, Gg, Gg^Ve, Gg, Gg
Gs^Fds, Gs^Fds, Rd, Rd, Gg, Gg, Gg^Vh, Gg, Ch, 2 Kh, Ch, Ch, Gg^Ve, Rd, Rd, Gg, Gg, Gg, Gg, Gs^Fds, Gs^Fds, Gs^Fds, Gs^Fds, Hh^Fds, Gs^Fds, Gs^Fds, Gs^Fds, Gs^Fds, Gs^Fds, Gs^Fds, Gs^Fds, Gs^Fds, Gs^Fds, Gg, Rd, Rd, Rd, Gs^Fds, Gs^Fds, Gs^Fds, Gs^Fds, Gs^Fds, Gs^Fds, Gg, Gg, Gg
Gs^Fds, Gs^Fds, Rd, Gg^Vh, Gg, Gg, Gg, Gg, Rd, Ch, Ch, Ch, Rd, Rd, Rd, Gg, Gg, Gg, Gg, Gs^Fds, Gs^Fds, Gs^Fds, Gs^Fds, Gs^Fds, Gs^Fds, Gs^Fds, Gs^Fds, Gs^Fds, Gs^Fds, Gg^Vh, Gs^Fds, Gs^Fds, Gs^Fds, Gs^Fds, Gs^Fds, Rd, Rd, Rd, Co, Gs^Fds, Gs^Fds, Gs^Fds, Gs^Fds, Gs^Fds, Gs^Fds, Gg
Gs^Fds, Gs^Fds, Rd, Gg, Gg, Gg, Gg, Gg, Rd, Rd, Rd, Rd, Rd, Rd, Gg, Gg, Gg, Gg, Gg, Gg, Gs^Fds, Gs^Fds, Hh^Fds, Hh^Fds, Hh, Gs^Fds, Gs^Fds, Gs^Fds, Gs^Fds, Gs^Fds, Gs^Fds, Gs^Fds, Gs^Fds, Gs^Fds, Gs^Fds, Gs^Fds, Gs^Fds, Co, 4 Ko, Co, Gs^Fds, Gs^Fds, Gs^Fds, Gs^Fds, Gs^Fds, Gs^Fds
Gs^Fds, Gs^Fds, Rd, Gg, Gg, Gg, Gg, Gg, Rd, Rd, Rd, Rd, Gg, Gg, Gg, Gg, Gg, Gg, Gg, Gg, Gs^Fds, Hh^Vhh, Md, Hh^Fds, Hh, Gs^Fds, Gs^Fds, Gs^Fds, Gs^Fds, Gs^Fds, Gs^Fds, Gs^Fds, Gs^Fds, Gg^Ve, Gs^Fds, Gs^Fds, Gs^Fds, Co, Co, Co, Gs^Fds, Gs^Fds, Gs^Fds, Gs^Fds, Gs^Fds, Gs^Fds
Gs^Fds, Gs^Fds, Rd, Gg, Gg, Gg, Gg, Gg, Rd, Rd, Gg, Gg, Gg^Vh, Gg, Gg, Gg, Gg, Gg, Gg, Gg, Hh, Hh, Md, Hh, Gs^Fds, Gs^Fds, Gs^Fds, Gs^Fds, Gs^Fds, Gs^Fds, Gs^Fds, Gs^Fds, Gs^Fds, Gs^Fds, Gs^Fds, Gs^Fds, Gs^Fds, Co, Co, Co, Gs^Fds, Gs^Fds, Gs^Fds, Gs^Fds, Gs^Fds, Gs^Fds
Gs^Fds, Gs^Fds, Gg, Rd, Rd, Gg, Gg, Gg, Rd, Rd, Gg, Gg, Gg, Gg, Gg, Gg, Gg, Gg, Gg, Gg, Hh, Md, Hh, Hh, Gs^Fds, Gs^Fds, Gs^Fds, Gs^Fds, Gs^Fds, Gs^Fds, Ss, Ss, Ss, Gs^Fds, Gs^Fds, Gs^Fds, Gs^Fds, Gs^Fds, Gs^Fds, Gs^Fds, Gs^Fds, Gs^Fds, Gs^Fds, Gs^Fds, Gs^Fds, Md
Gs^Fds, Gs^Fds, Gg, Gg, Gg, Rd, Rd, Rd, Gg, Gg, Gg, Gg, Gg, Gg, Gg, Gg, Gs^Fds, Gs^Fds, Hh, Hh, Md, Md, Hh, Gs^Fds, Gs^Fds, Gs^Fds, Gs^Fds, Gs^Fds, Ss, Ss, Ss, Ss, Ss, Ss, Ss, Gs^Fds, Ss, Gs^Fds, Gs^Fds, Gs^Fds, Gs^Fds, Gs^Fds, Gs^Fds, Gs^Fds, Gs^Fds, Md
Gs^Fds, Gs^Fds, Gs^Fds, Gg, Gg, Gg, Rd, Gg, Gg, Gg, Gg, Gg, Gg, Gg, Gg, Gs^Fds, Gs^Fds, Gs^Fds, Hh, Md, Md, Hh, Hh, Gs^Fds, Gs^Fds, Gs^Fds, Ww, Ss^Vhs, Ss, Ss, Ss, Ss, Ss, Ss, Ss, Ss, Ww, Ss, Ss, Gs^Fds, Gs^Fds, Gs^Fds, Gs^Fds, Gs^Fds, Gs^Fds, Md
Gs^Fds, Gs^Fds, Gs^Fds, Gg, Gg, Gg, Rd, Gg, Gs^Vh, Gg, Gg, Gg, Gg, Gg, Gg, Gs^Fds, Hh^Fds, Hh^Fds, Md, Md, Hh^Vhh, Hh, Hh, Gs^Fds, Ww, Ww, Ss, Ww, Ww, Ss, Ww, Ss, Ss, Ss, Ss, Ss^Vhs, Ss, Ww, Ss, Ss, Gs^Fds, Gs^Fds, Gs^Fds, Gs^Fds, Hh^Vhh, Md
Hh, Gs^Fds, Gs^Fds, Gs^Fds, Gs^Fds, Gg, Gg, Rd, Rd, Gg, Gg, Gg, Gg, Gg, Gg, Gs^Fds, Hh^Fds, Hh^Fds, Chr, Md, Chr, Hh, Ww, Ww, Ss, Ss, Ss, Ss, Ss, Ww, Ss, Ww, Ss, Ss, Ss, Ss, Ss, Ww, Ss, Ss, Gs^Fds, Gs^Fds, Gs^Fds, Hh^Fds, Md, Md
Hh, Hh, Hh, Gs^Fds, Gs^Fds, Gg, Gg, Gg, Gg, Rd, Gg, Gg, Gg, Gg, Gs^Fds, Gs^Fds, Hh^Fds, Hh^Fds, Md, Khr, Md, Hh, Ww, Ss, Ww, Ss, Ss, Ss, Ss, Ss, Ss, Ss^Vhs, Ss, Ss, Ss, Ss, Ww, Ww, Ss, Ss, Gs^Fds, Gs^Fds, Hh^Fds, Hh^Fds, Md, Md
Hh, Hh, Hh, Gs^Fds, Gs^Fds, Gs^Fds, Gg, Gg, Gg, Rd, Gg, Gg, Gg, Gg, Gs^Fds, Gs^Fds, Hh^Fds, Md, Md, Chr, Mm, Hh, Hh, Ww, Ss, Ww, Ss, Ss, Ss, Ss, Ss, Ss, Ss, Ss, Ww, Ss, Ss, Ww, Ss, Gs^Fds, Gs^Fds, Gs^Fds, Hh^Fds, Hh^Fds, Md, Md
Hh, Hh, Hh, Hh, Hh, Gs^Fds, Gs^Fds, Gg, Gg, Rd, Gg, Gg, Gg, Gg, Gs^Fds, Hh^Fds, Hh, Md, Md, Md, Mm, Mm, Hh, Ww, Ss, Ss^Vhs, Ss, Ss, Ss, Ss, Ss, Ss, Ss, Ww, Ss, Ww, Ww, Ww, Ss, Gs^Fds, Gs^Fds, Hh^Fds, Hh^Fds, Md, Md, Md
Hh, Hh, Hh^Vhh, Hh, Hh, Gs^Fds, Gg, Gg, Gg, Rd, Gg^Ve, Gg, Gg, Gg, Gs^Fds, Hh^Fds, Hh^Fds, Hh^Vhh, Md, Md, Mm, Hh, Hh, Ww, Ss, Ss, Ss, Ss, Ww, Ww, Ss, Ss, Ss, Ss, Ss, Ss^Vhs, Ww, Ww, Gs^Fds, Gs^Fds, Hh^Fds, Hh^Fds, Md, Md, Md, Md
Hhd, Hh, Hh, Hh, Gs^Fds, Gs^Fds, Gg, Gg, Rd, Rd, Gg, Gg, Gg, Gg, Gs^Fds, Hh^Fds, Hh, Hh, Md, Md, Mm, Hh, Hh, Ww, Ww, Ss, Ww, Ww, Ss, Ww, Ww, Ss, Ss, Ss, Ss, Ss, Ww, Ww, Gs^Fds, Gs^Fds, Hh^Fds, Hh^Vhh, Md, Md, Md, Md
Hhd, Hh, Hh, Hh, Gs^Fds, Gg, Gg, Gg, Rd, Gg, Gg, Gg, Gg, Gs^Fds, Gs^Fds, Hh^Fds, Hh, Md, Md, Md, Md, Mm, Hh, Ww, Ss, Ww, Ss, Ss, Ss, Ww, Ww, Ww, Ss, Ss, Ss, Ss, Ww, Gs^Fds, Gs^Fds, Gs^Fds, Hh^Fds, Md, Md, Md, Md, Md
Hh, Hh, Hh, Hh, Gs^Fds, Gg, Gg, Gg, Rd, Gg, Gg, Gg, Gs^Fds, Gs^Fds, Hh^Fds, Hh, Md, Md, Md, Md, Md, Md, Hh, Ww, Ss, Ss, Ss, Ss, Ss, Ss, Ww, Ww, Ss, Ss, Ww, Ww, Gs^Fds, Gs^Fds, Gs^Fds, Hh^Fds, Md, Md, Md, Md, Md, Md
Hh, Hh, Hh, Gs^Fds, Gg, Gg, Gg, Gg, Rd, Gg, Gg, Gs^Fds, Hh^Fds, Hh^Fds, Hh^Vhh, Md, Md, Md, Hh, Md, Hh, Hh, Hh, Hh, Ss, Ss, Ss, Ss, Ss, Ss^Vhs, Ww, Ww, Ww, Ww, Ss, Ss, Gs^Fds, Gs^Fds, Hh^Fds, Hh^Fds, Md, Md, Md, Md, Md, Md
Hh, Hh, Hh, Gs^Fds, Gg, Gg, Rd, Rd, Gg, Gg, Gs^Fds, Gs^Fds, Hh^Fds, Hh^Fds, Hh^Fds, Hh, Hh, Hh, Hh, Hh, Hh, Hh, Hh^Fds, Ss, Ss, Ss, Ss, Ss, Ss, Ss, Ww, Ww, Chw, Ww, Ss, Ss, Gs^Fds, Gs^Fds, Hh^Fds, Hh^Vhh, Md, Md, Md, Md, Md, Md
Hh, Hh, Hh, Gs^Fds, Gg, Gg, Rd, Gg, Gg, Gg, Gs^Fds, Gs^Fds, Chr, Hh^Fds, Hh^Fds, Hh^Fds, Hh^Fds, Hh^Fds, Hh^Fds, Hh, Hh^Fds, Hh^Fds, Ss, Ss, Ss, Ss, Ss, Ss, Ww, Ww, Ww, Chw, Khw, Chs, Ss, Ss, Gs^Fds, Gs^Fds, Hh^Fds, Md, Md, Md, Md, Md, Md, Md
Hh, Hh, Hh, Gs^Fds, Gg, Gg, Rd, Gg, Gg, Gg, Gg, Chr, Khr, Chr, Hh^Fds, Hh^Fds, Gg, Gg, Gg, Hh^Fds, Hh^Fds, Hh^Fds, Ss, Ss, Ss, Ss, Ww, Ww, Ww, Ww, Ss, Chw, Chs, Chs, Ss, Gs^Fds, Gs^Fds, Gs^Fds, Hh^Fds, Md, Md, Md, Md, Md, Md, Md
Hh, Hh, Hh, Gs^Fds, Gs^Fds, Gs^Vh, Rd, Gg, Gg, Gg, Gg, Chr, Chr, Chr, Gg, Gg, Rd, Gs^Vh, Gg, Gs^Fds, Gs^Fds, Ss, Ss, Ss, Ss, Ss, Ss, Ss^Vhs, Ww, Ww, Ss, Ss, Ss, Ss, Gg, Gs^Fds, Gs^Fds, Hh^Fds, Md, Md, Md, Md, Md, Md, Md, Md
Hh, Hh, Hh, Hh, Gs^Fds, Gg, Gg, Rd, Rd, Rd, Rd, Rd, Rd, Rd, Rd, Rd, Gg, Rd, Rd, Rd, Rd, Gg, Gg, Ss, Ss, Ss, Ww, Ww, Ww, Ss, Gg, Gg, Gg, Gg, Gs^Vh, Gs^Fds, Gs^Fds, Gs^Fds, Hh^Fds, Md, Md, Md, Md, Md, Md, Md
Hh, Hh, Hh, Hh, Gs^Fds, Gs^Fds, Gs^Fds, Gg, Gg, Gg, Gg, Gg, Gg, Gg, Gg, Gg, Gg, Gg, Gg, Gg, Ss, Rd, Rd, Ss, Ss, Ww, Ww, Ww, Ss, Ss, Gg, Gg, Gg, Gg, Gg, Gs^Fds, Gs^Fds, Gs^Fds, Gs^Fds, Md, Md, Md, Md, Md, Md, Md
Ww, Hh, Hh, Hh, Hh, Gs^Fds, Gs^Fds, Gs^Fds, Gg, Gg, Gg, Gg, Gg, Gg, Gg, Gg, Ss, Gg, Ss, Ss, Ss, Ss, Ww^Bw|, Ss, Ww, Ww, Ww, Ss, Gg, Gg, Gg, Gg, Gg, Gg, Gs^Fds, Gs^Fds, Gs^Fds, Gs^Fds, Gs^Fds, Hh^Fds, Md, Md, Md, Md, Md, Md
Hh, Ww, Ww, Hh, Ww, Hh, Hh, Hh, Hh, Ss, Ss, Ss, Ss, Ss, Ss, Ss, Ss, Ss, Ss, Ss, Ww, Ww, Ww^Bw|, Ww, Ww, Ww, Gg, Gg, Gg, Gg, Gg, Gg, Gg, Gg, Gs^Fds, Gs^Fds, Gs^Fds, Gs^Fds, Hh^Fds, Hh^Fds, Hh^Fds, Md, Md, Md, Md, Md
Hh^Fds, Hh, Hh, Ww, Hh, Ww, Ww, Ww, Ww, Ss, Ww, Ss^Vhs, Ww, Ss, Ww, Ww, Ww, Ww, Ww, Ww, Ww, Ww, Rd, Ww, Gg, Gg, Gg, Gg, Gg, Gg, Gs^Fds, Gs^Fds, Gs^Fds, Gs^Fds, Gs^Fds, Gs^Fds, Gs^Fds, Gs^Fds, Hh^Fds, Hh^Fds, Md, Md, Md, Md, Md, Md
Hh^Fds, Hh^Fds, Hh^Fds, Hh, Hh^Fds, Hh, Hh^Fds, Hh, Hh, Ww, Hh, Ww, Hh, Ww, Gg, Ww, Gg, Ww, Ww, Ww, Gg, Gg, Rd, Gg, Gg, Gg, Gg^Vh, Gg, Gs^Fds, Gs^Fds, Gs^Fds, Gs^Fds, Gs^Fds, Gs^Fds, Gs^Fds, Gs^Fds, Hh^Fds, Hh^Fds, Hh^Fds, Hh^Fds, Md, Md, Md, Md, Md, Md
Hh^Fds, Hh^Fds, Hh^Fds, Hh^Fds, Hh^Fds, Hh^Fds, Hh^Fds, Hh^Fds, Hh^Fds, Hh, Hh^Fds, Hh, Gs^Fds, Gg, Gs^Fds, Gg, Gg, Gg, Gg, Gg, Gg, Rd, Rd, Gg, Gg, Gg, Gs^Fds, Gs^Fds, Gs^Fds, Gs^Fds, Gs^Fds, Gs^Fds, Gs^Fds, Gs^Fds, Hh^Fds, Hh^Fds, Hh^Fds, Hh^Fds, Md, Md, Md, Md, Md, Md, Md, Md
Hh^Fds, Hh^Fds, Hh^Fds, Hh^Fds, Hh^Fds, Hh^Vhh, Hh^Fds, Hh^Fds, Hh^Fds, Hh^Fds, Hh^Fds, Gs^Fds, Gs^Fds, Gs^Fds, Gs^Fds, Gs^Vh, Gs^Fds, Gg, Gg, Gg, Gg, Rd, 1 Rd, Gg, Gs^Fds, Gs^Fds, Gs^Fds, Gs^Fds, Gs^Fds, Gs^Fds, Gs^Fds, Gs^Fds, Hh^Fds, Hh^Fds, Hh^Fds, Hh^Fds, Hh^Fds, Hh^Fds, Md, Md, Md, Md, Md, Md, Md, Md
Hh^Fds, Hh^Fds, Hh^Fds, Hh^Fds, Hh^Fds, Hh^Fds, Hh^Fds, Hh^Fds, Hh^Fds, Hh^Fds, Gs^Fds, Gs^Fds, Gs^Fds, Gs^Fds, Gs^Fds, Gs^Fds, Gs^Fds, Gg, Gg, Gg, Rd, Rd, Rd, Gg, Gs^Fds, Gs^Fds, Gs^Fds, Gs^Fds, Gs^Fds, Gs^Fds, Hh^Fds, Hh^Fds, Hh^Fds, Hh^Fds, Hh^Fds, Hh^Fds, Md, Md, Md, Md, Md, Md, Md, Md, Md, Md
Hh^Fds, Hh^Fds, Hh^Fds, Hh^Fds, Hh^Fds, Hh^Fds, Hh^Fds, Hh^Fds, Gs^Fds, Gs^Fds, Gs^Fds, Gs^Fds, Gs^Fds, Gs^Fds, Gs^Fds, Gs^Fds, Gs^Fds, Gs^Fds, Gs^Fds, Gg, Rd, Rd, Rd, Rd, Gs^Fds, Gs^Fds, Gs^Fds, Gs^Fds, Gs^Fds, Hh^Fds, Hh^Fds, Hh^Fds, Hh^Fds, Hh^Fds, Hh^Fds, Hh, Md, Md, Md, Md, Md, Md, Md, Md, Md, Md
