Ms, Ms, Ms, Ms, Ms, Ms, Ms, Ms, Wwt, Ms, Ms, Ms, Ms, Ms, Ms, Ms, Ms, Ms, Ms, Ms, Ms, Ms, Ms, Ms, Ms, Ms
Ms, Ms, Ms, Ms, Ms, Mm, Mm, Mm, Wwt, Mm, Mm, Ms, Ms, Ms, Ms, Ms, Ms, Ms, Ms, Ms, Ms, Ms, Ms, Ms, Ms, Ms
Ms, Ms, Ms, Ms, Ms, Mm, Hh, Hh, Wwt, Hh, Hh, Mm, Mm, Ms, Ms, Ms, Mm, Mm, Mm, Ms, Mm, Ms, Mm, Mm, Ms, Ms
Mm, Ms, Ms, Ms, Ms, Mm, Hh, Hh, Wwt, Wwt, Wwt, Hh, Hh, Mm, Mm, Mm, Mm, Mm, Mm, Mm, Gs^Fp, Mm, Mm, Mm, Ms, Ms
Mm, Mm, Mm, Mm, Mm, Mm, Hh, Wwt, Wwt, Wwt, Wwt, Wwt, Wwt, Hh, Hh, Mm, Mm, Mm, Gs^Fp, Gs^Fp, Gs^Fms, Gs^Fp, Mm, Ms, Ms, Ms
Ms, Hh, Hh, Mm, Hh, Mm, Hh^Fp, Wwt, Wwt, Wwt, Wwt, Wwt, Wwt, Hh^Fp, Hh, Mm, Gs^Fp, Gs^Fp, Gs^Fms, Gs^Fms, Gs^Fms, Gs^Fp, Mm, Ms, Ms, Ms
Ms, Mm, Hh^Fp, Hh^Fp, Hh^Fp, Hh^Fp, Hh^Fp, Wwt, Wwt, Wwt, Wwt, Wwt, Wwt, Wwt, Gs^Fms, Gs^Fp, Gs^Fms, Gs^Fms, Gs^Fms, Gs^Fms, Gs^Fp, Hh, Mm, Ms, Ms, Ms
Ms, Mm, Hh, Hh^Fp, Hh^Fp, Hh^Fp, Gs^Fms, Wwt, Wwt, Wwt, Wwt, Wwt, Wwt, Wwt, Wwt, Gs^Fms, Gs^Fms, Gs^Fms, Gs^Fms, Gs^Fp, Hh, Mm, Mm, Ms, Ms, Ms
Ms, Ms, Mm, Hh, Hh, Gs^Fms, Gs^Fms, Gg, Wwt, Wwt, Wwt, Gg, Gg, Wwt, Wwt, Gg, Gg, Gs^Fms, Gs^Fms, Hh, Mm, Mm, Mm, Ms, Ms, Ms
Ms, Ms, Mm, Mm, Gs^Fms, Gs^Fms, Gg, Gg, Gg, Wwt, Wwt, Wwt, Wwt, Wwt, Wwt, Gg, Gg, Gs^Fms, Gs^Fms, Hh, Mm, Mm, Ms, Ms, Ms, Ms
Ms, Ms, Ms, Mm, Gs^Fms, Gs^Fms, Gg, Gg, Gg, Gg, Gg, Gg, Gg, Wwt, Wwt, Gg, Wwt, Gg, Gs^Fms, Hh, Mm, Mm, Ms, Ms, Ms, Ms
Ms, Ms, Ms, Mm, Gs^Fp, Gs^Fms, Gs^Fms, Gg, Gg, Wwt, Wwt, Wwt, Gg, Gg, Wwt, Gg, Wwt, Gg, Gg, Hh, Mm, Mm, Ms, Ms, Ms, Ms
Ms, Ms, Ms, Mm, Mm, Gs^Fp, Gs^Fms, Gs^Fms, Gs^Fms, Gg, Gs^Fms, Gg, Gg, Gg, Wwt, Gg, Gg, Gg, Gg, Hh, Mm, Mm, Ms, Ms, Ms, Ms
Ms, Ms, Mm, Mm, Mm, Hh, Gs^Fms, Gs^Fms, Gs^Fms, Gs^Fms, Gs^Fms, Gs^Fms, Gs^Fms, Gg, Gg, Wwt, Wwt, Gg, Hh, Mm, Mm, Mm, Mm, Ms, Mm, Ms
Ms, Ms, Ms, Mm, Hh, Hh, Gs^Fp, Gs^Fms, Hh, Gs^Fms, Hh, Gs^Fp, Hh, Gg, Hh, Gg, Wwt, Hh, Chr, Chr, Chr, Mm, Wot, Mm, Wwt, Wwt
Ms, Ms, Ms, Mm, Mm, Gs^Fp, Gs^Fp, Gs^Fp, Hh, Hh, Mm, Hh, Mm, Hh, Mm, Hh, Mm, Wwt, Chr, 1 Chr, Chr, Wot, Wot, Wot, Mm, Mm
Ms, Ms, Ms, Ms, Ms, Mm, Mm, Mm, Ms, Mm, Ms, Mm, Ms, Mm, Ms, Mm, Mm, Wwt, Wwt, Chr, Wot, Wot, Wot, Wot, Mm, Ms
Ms, Ms, Ms, Ms, Ms, Ms, Ms, Ms, Ms, Ms, Ms, Ms, Ms, Ms, Ms, Mm, Mm, Mm, Mm, Wot, Wot, Wot, Wot, Wot, Mm, Ms
Ms, Ms, Ms, Ms, Ms, Ms, Ms, Ms, Ms, Ms, Ms, Ms, Ms, Ms, Ms, Ms, Ms, Mm, Mm, Wot, Wot, Wot, Wot, Wot, Mm, Ms
Ms, Ms, Ms, Ms, Mm, Mm, Wwt, Mm, Mm, Mm, Mm, Mm, Mm, Ms, Mm, Mm, Mm, Mm, Mm, Wot, Wot, Wot, Mm, Mm, Ms, Ms
Ms, Ms, Mm, Mm, Wwt, Wwt, Mm, Wwt, Wwt, Wwt, Wwt, Wwt, Wwt, Mm, Wwt, Wwt, Wwt, Wwt, Wwt, Wwt, Mm, Mm, Ms, Ms, Ms, Ms
Ms, Mm, Wwt, Wwt, Mm, Mm, Mm, Mm, Ms, Mm, Mm, Mm, Ms, Wwt, Ms, Mm, Mm, Mm, Mm, Mm, Ms, Ms, Ms, Ms, Ms, Ms
