Wot, Wot, Wot, Wot, Wot, Wot, Wot, Wot, Wot, Wot, Wo, Wog, Xos, Ch, Ch, Ch, Ch, Ch, Ch, Ch, Xos, Wog, Wo, Wot, Wot, Wot, Wo, Wog, Xos, Ch, Ch, Ch, Ch, Ch, Ch, Ch, Xos, Wog, Wo, Wot, Wot, Wot, Wot, Wot, Wot, Wot, Wot, Wot, Wot
Wot, Wot, Wot, Wot, Wot, Wot, Wot, Wot, Wot, Wot, Wo, Wog, Xos, Ch, Ch, Kud, Ch, Ch, Ch, Ch, Xos^Efs, Wog, Wo, Wot, Wot, Wot, Wo, Wog, Xos^Efs, Ch, Ch, Ch, Ch, Kud, Ch, Ch, Xos, Wog, Wo, Wot, Wot, Wot, Wot, Wot, Wot, Wot, Wot, Wot, Wot
Wot, Wot, Wot, Wot, Wot, Wot, Wot, Wot, Wot, Wot, Wo, Wog, Xos, Ch, Ch, Ch, Ch, Ch, Rrc, Rrc, Xos, Wog, Wog, Wo, Wo, Wo, Wog, Wog, Xos, Rrc, Rrc, Ch, Ch, Ch, Ch, Ch, Xos, Wog, Wo, Wot, Wot, Wot, Wot, Wot, Wot, Wot, Wot, Wot, Wot
Wot, Wot, Wot, Wot, Wot, Wot, Wot, Wot, Wot, Wot, Wo, Wog, Xos^Efs, Rrc, Rrc, Ch, Xos^Efs, Xos^Efs, Rrc, Rrc, Rrc, Xos, Xos, Wog, Wog, Wog, Xos, Xos, Rrc, Rrc, Rrc, Xos^Efs, Xos^Efs, Ch, Rrc, Rrc, Xos^Efs, Wog, Wo, Wot, Wot, Wot, Wot, Wot, Wot, Wot, Wot, Wot, Wot
Wot, Wot, Wot, Wot, Wot, Wot, Wot, Wot, Wot, Wot, Wo, Wog, Xos^Efs, Rrc, Rrc, Xos^Efs, Rrc, Rrc, Rrc, Rrc, Rrc, Rrc, Rrc, Xos, Xos, Xos, Rrc, Rrc, Rrc, Rrc, Rrc, Rrc, Rrc, Xos^Efs, Rrc, Rrc, Xos^Efs, Wo, Wo, Wot, Wot, Wot, Wot, Wot, Wot, Wot, Wot, Wot, Wot
Wot, Wot, Wot, Wot, Wot, Wot, Wot, Wot, Wo, Wo, Wog, Wog, Xos^Efs, Rrc, Rrc, Xos^Efs, Rrc, Rrc, Rrc, Rrc, Rrc, Rrc, Xos^Efs, Xos^Efs, Rrc, Xos^Efs, Xos^Efs, Rrc, Rrc, Rrc, Rrc, Rrc, Rrc, Xos^Efs, Rrc, Rrc, Xos^Efs, Wog, Wog, Wo, Wo, Wot, Wot, Wot, Wot, Wot, Wot, Wot, Wot
Wot, Wot, Wot, Wot, Wot, Wot, Wo, Wo, Wog, Wog, Xos^Efs, Xos^Efs, Rrc, Rrc, Rrc, Xos^Efs, Rrc, Rrc, Rrc, Rrc, Xos^Efs, Xos^Efs, Rrc, Rrc, Rrc, Rrc, Rrc, Xos^Efs, Xos^Efs, Rrc, Rrc, Rrc, Rrc, Xos^Efs, Rrc, Rrc, Rrc, Xos^Efs, Xos^Efs, Wog, Wog, Wo, Wo, Wot, Wot, Wot, Wot, Wot, Wot
Wot, Wot, Wot, Wot, Wo, Wo, Wog, Wog, Xos^Efs, Xos^Efs, Rrc, Rrc, Rrc, Rrc, Xos^Efs, Xos^Efs, Xos^Efs, Rrc, Xos^Efs, Xos^Efs, Rrc, Rrc, Rrc, Rrc, Rrc, Rrc, Rrc, Rrc, Rrc, Xos^Efs, Xos^Efs, Rrc, Xos^Efs, Xos^Efs, Xos^Efs, Rrc, Rrc, Rrc, Rrc, Xos^Efs, Xos^Efs, Wog, Wog, Wo, Wo, Wot, Wot, Wot, Wot
Wot, Wot, Wo, Wo, Wog, Wog, Xos^Efs, Xos^Efs, Rrc, Rrc, Rrc, Rrc, Xos^Efs, Xos^Efs, Rrc, Rrc, Rrc, Xos^Efs, Xos^Efs, Rrc, Rrc, Rrc, Rrc, Rrc, Rrc, Rrc, Rrc, Rrc, Rrc, Rrc, Xos^Efs, Xos^Efs, Rrc, Rrc, Rrc, Xos^Efs, Xos^Efs, Rrc, Rrc, Rrc, Rrc, Xos^Efs, Xos^Efs, Wog, Wog, Wo, Wo, Wot, Wot
Wot, Wo, Wo, Wog, Xos^Efs, Xos^Efs, Rrc, Rrc, Rrc, Rrc, Xos^Efs, Xos^Efs, Rrc, Rrc, Rrc, Rrc, Rrc, Rrc, Rrc, Xos^Efs, Xos^Efs, Rrc, Rrc, Rrc, Rrc, Rrc, Rrc, Rrc, Xos^Efs, Xos^Efs, Rrc, Rrc, Rrc, Rrc, Rrc, Rrc, Rrc, Xos^Efs, Xos^Efs, Rrc, Rrc, Rrc, Rrc, Xos^Efs, Xos^Efs, Wog, Wog, Wo, Wot
Wot, Wo, Wog, Xos^Efs, Rrc, Rrc, Rrc, Rrc, Xos^Efs, Xos^Efs, Ch, Ch, Ch, Rrc, Rrc, Rrc, Rrc, Rrc, Rrc, Rrc, Rrc, Xos^Efs, Xos^Efs, Rrc, Rrc, Rrc, Xos^Efs, Xos^Efs, Rrc, Rrc, Rrc, Rrc, Rrc, Rrc, Rrc, Rrc, Ch, Ch, Ch, Xos^Efs, Xos^Efs, Rrc, Rrc, Rrc, Rrc, Xos^Efs, Wog, Wo, Wot
Wot, Wo, Wog, Xos^Efs, Rrc, Rrc, Xos^Efs, Xos^Efs, Ch, Ch, Kud, Ch, Ch, Ch, Ch, Xos^Efs, Xos^Efs, Rrc, Rrc, Rrc, Rrc, Rrc, Rrc, Rrc, Ch, Rrc, Rrc, Rrc, Rrc, Rrc, Rrc, Rrc, Xos^Efs, Xos^Efs, Ch, Ch, Ch, Ch, Kud, Ch, Ch, Xos^Efs, Xos^Efs, Rrc, Rrc, Xos^Efs, Wog, Wo, Wot
Wo, Wo, Wog, Xos^Efs, Rrc, Rrc, Ch, Xos^Efs, Xos^Efs, Ch, Ch, Ch, Xos^Efs, Ch, Ch, Ch, Ch, Xos^Efs, Xos^Efs, Rrc, Rrc, Rrc, Ch, Ch, Ch, Ch, Ch, Rrc, Rrc, Rrc, Xos^Efs, Xos^Efs, Ch, Ch, Ch, Ch, Xos^Efs, Ch, Ch, Ch, Xos^Efs, Xos^Efs, Ch, Rrc, Rrc, Xos^Efs, Wog, Wo, Wo
Wo, Wog, Xos^Efs, Xos^Efs, Ch, Ch, Ch, Ch, Ch, Xos^Efs, Xos^Efs, Xos^Efs, Ch, Ch, Ch, Ch, Ch, Ch, Xos^Efs, Xos^Efs, Ch, Ch, Ch, Ch, Ch, Ch, Ch, Ch, Ch, Xos^Efs, Xos^Efs, Ch, Ch, Ch, Ch, Ch, Ch, Xos^Efs, Xos^Efs, Xos^Efs, Ch, Ch, Ch, Ch, Ch, Xos^Efs, Xos^Efs, Wog, Wo
Wo, Wog, Xos^Efs, Ch, Ch, Ch, Ch, Ch, Ch, Xos^Efs, Ch, Ch, Ch, Ch, Ch, Ch, Xos^Efs, Xos^Efs, Ch, Ch, Ch, Ch, Ch, Ch, Ch, Ch, Ch, Ch, Ch, Ch, Ch, Xos^Efs, Xos^Efs, Ch, Ch, Ch, Ch, Ch, Ch, Xos^Efs, Ch, Ch, Ch, Ch, Ch, Ch, Xos^Efs, Wog, Wo
Wo, Wog, Xos^Efs, Ch, Ch, Ch, Ch, Ch, Ch, Xos^Efs, Ch, Ch, Ch, Ch, Xos^Efs, Xos^Efs, Ch, Ch, Ch, Ch, Ch, Ch, Ch, Ch, Ch, Ch, Ch, Ch, Ch, Ch, Ch, Ch, Ch, Xos^Efs, Xos^Efs, Ch, Ch, Ch, Ch, Xos^Efs, Ch, Ch, Ch, Ch, Ch, Ch, Xos^Efs, Wog, Wo
Wo, Wog, Xos^Efs, Ch, Ch, Kud, Ch, Ch, Ch, Xos^Efs, Ch, Ch, Ch, Xos^Efs, Xos^Efs, Ch, Ch, Ch, Ch, Ch, Ch, Ch, Ch, Ch, Ch, Ch, Ch, Ch, Ch, Ch, Ch, Ch, Ch, Ch, Xos^Efs, Xos^Efs, Ch, Ch, Ch, Xos^Efs, Ch, Ch, Ch, Kud, Ch, Ch, Xos^Efs, Wog, Wo
Wo, Wog, Xos^Efs, Ch, Ch, Ch, Ch, Ch, Ch, Xos^Efs, Ch, Ch, Ch, Ch, Ch, Xos^Efs, Xos^Efs, Ch, Ch, Ch, Ch, Ch, Kud, Ch, Ch, Ch, Kud, Ch, Ch, Ch, Ch, Ch, Xos^Efs, Xos^Efs, Ch, Ch, Ch, Ch, Ch, Xos^Efs, Ch, Ch, Ch, Ch, Ch, Ch, Xos^Efs, Wog, Wo
Wo, Wog, Xos^Efs, Ch, Ch, Ch, Ch, Ch, Rrc, Xos^Efs, Xos^Efs, Ch, Ch, Ch, Ch, Ch, Ch, Xos^Efs, Xos^Efs, Ch, Ch, Ch, Ch, Ch, Ch, Ch, Ch, Ch, Ch, Ch, Xos^Efs, Xos^Efs, Ch, Ch, Ch, Ch, Ch, Ch, Xos^Efs, Xos^Efs, Rrc, Ch, Ch, Ch, Ch, Ch, Xos^Efs, Wog, Wo
Wo, Wog, Wog, Xos^Efs, Xos^Efs, Ch, Xos^Efs, Rrc, Rrc, Rrc, Rrc, Xos^Efs, Rrc, Ch, Ch, Ch, Ch, Ch, Xos^Efs, Xos^Efs, Xos^Efs, Ch, Ch, Ch, Ch, Ch, Ch, Ch, Xos^Efs, Xos^Efs, Xos^Efs, Ch, Ch, Ch, Ch, Ch, Rrc, Xos^Efs, Rrc, Rrc, Rrc, Rrc, Xos^Efs, Ch, Xos, Xos, Wog, Wog, Wo
Wot, Wo, Wo, Wog, Wog, Xos^Efs, Rrc, Rrc, Rrc, Rrc, Rrc, Rrc, Rrc, Rrc, Xos^Efs, Ch, Xos^Efs, Xos^Efs, Ch, Ch, Ch, Xos^Efs, Xos^Efs, Ch, Ch, Ch, Xos^Efs, Xos^Efs, Ch, Ch, Ch, Xos^Efs, Xos^Efs, Ch, Xos^Efs, Rrc, Rrc, Rrc, Rrc, Rrc, Rrc, Rrc, Rrc, Xos, Wog, Wog, Wo, Wo, Wot
Wot, Wot, Wot, Wo, Wog, Xos, Rrc, Rrc, Rrc, Rrc, Rrc, Rrc, Rrc, Rrc, Xos^Efs, Xos^Efs, Ch, Ch, Ch, Ch, Ch, Ch, Ch, Xos^Efs, Xos^Efs, Xos^Efs, Ch, Ch, Ch, Ch, Ch, Ch, Ch, Xos^Efs, Xos^Efs, Rrc, Rrc, Rrc, Rrc, Rrc, Rrc, Rrc, Rrc, Xos, Wog, Wo, Wot, Wot, Wot
Wot, Wot, Wot, Wo, Wog, Xos, Rrc, Rrc, Rrc, Rrc, Rrc, Rrc, Xos^Efs, Xos^Efs, Ch, Ch, Ch, Ch, Ch, Ch, Ch, Ch, Xos^Efs, Xos^Efs, Ch, Xos^Efs, Xos^Efs, Ch, Ch, Ch, Ch, Ch, Ch, Ch, Ch, Xos^Efs, Xos^Efs, Rrc, Rrc, Rrc, Rrc, Rrc, Rrc, Xos, Wog, Wo, Wot, Wot, Wot
Wot, Wot, Wot, Wo, Wog, Xos, Rrc, Rrc, Rrc, Rrc, Rrc, Xos^Efs, Xos^Efs, Ch, Ch, Ch, Ch, Ch, Ch, Ch, Xos^Efs, Xos^Efs, Ch, Ch, Ch, Ch, Ch, Xos^Efs, Xos^Efs, Ch, Ch, Ch, Ch, Ch, Ch, Ch, Xos^Efs, Xos^Efs, Rrc, Rrc, Rrc, Rrc, Rrc, Xos, Wog, Wo, Wot, Wot, Wot
Wot, Wot, Wo, Wo, Wog, Xos, Rrc, Rrc, Rrc, Rrc, Rrc, Rrc, Rrc, Rrc, Rrc, Ch, Ch, Ch, Xos^Efs, Xos^Efs, Ch, Ch, Ch, Ch, Kud, Ch, Ch, Ch, Ch, Xos^Efs, Xos^Efs, Ch, Ch, Ch, Rrc, Rrc, Rrc, Rrc, Rrc, Rrc, Rrc, Rrc, Rrc, Xos, Wog, Wo, Wo, Wot, Wot
Wo, Wo, Wog, Wog, Xos^Efs, Xos^Efs, Xos^Efs, Rrc, Rrc, Rrc, Rrc, Rrc, Rrc, Rrc, Rrc, Xos^Efs, Xos^Efs, Xos^Efs, Ch, Ch, Ch, Ch, Ch, Ch, Ch, Ch, Ch, Ch, Ch, Ch, Ch, Xos^Efs, Xos^Efs, Xos^Efs, Rrc, Rrc, Rrc, Rrc, Rrc, Rrc, Rrc, Rrc, Xos^Efs, Xos^Efs, Xos^Efs, Wog, Wog, Wo, Wo
Wo, Wog, Xos^Efs, Xos^Efs, Ch, Ch, Ch, Rrc, Rrc, Rrc, Rrc, Rrc, Rrc, Rrc, Rrc, Rrc, Rrc, Xos^Efs, Xos^Efs, Ch, Ch, Ch, Ch, Ch, Ch, Ch, Ch, Ch, Ch, Ch, Xos^Efs, Xos^Efs, Rrc, Rrc, Rrc, Rrc, Rrc, Rrc, Rrc, Rrc, Rrc, Rrc, Ch, Ch, Ch, Xos^Efs, Xos^Efs, Wog, Wo
Wo, Wog, Xos^Efs, Ch, Ch, Ch, Ch, Ch, Ch, Xos^Efs, Xos^Efs, Rrc, Rrc, Rrc, Rrc, Rrc, Rrc, Rrc, Rrc, Rrc, Rrc, Ch, Ch, Ch, Ch, Ch, Ch, Ch, Rrc, Rrc, Rrc, Rrc, Rrc, Rrc, Rrc, Rrc, Rrc, Rrc, Xos^Efs, Xos^Efs, Ch, Ch, Ch, Ch, Ch, Ch, Xos^Efs, Wog, Wo
Wo, Wog, Xos^Efs, Ch, Ch, Ch, Ch, Ch, Ch, Xos, Ch, Xos^Efs, Xos^Efs, Rrc, Rrc, Rrc, Rrc, Rrc, Rrc, Rrc, Rrc, Xos^Efs, Xos^Efs, Ch, Ch, Ch, Xos^Efs, Xos^Efs, Rrc, Rrc, Rrc, Rrc, Rrc, Rrc, Rrc, Rrc, Xos^Efs, Xos^Efs, Ch, Xos^Efs, Ch, Ch, Ch, Ch, Ch, Ch, Xos^Efs, Wog, Wo
Wo, Wog, Xos^Efs, Ch, Ch, Kud, Ch, Ch, Ch, Xos, Ch, Ch, Ch, Xos^Efs, Xos^Efs, Rrc, Rrc, Rrc, Rrc, Rrc, Rrc, Rrc, Rrc, Xos^Efs, Xos^Efs, Xos^Efs, Rrc, Rrc, Rrc, Rrc, Rrc, Rrc, Rrc, Rrc, Xos^Efs, Xos^Efs, Ch, Ch, Ch, Xos^Efs, Ch, Ch, Ch, Kud, Ch, Ch, Xos^Efs, Wog, Wo
Wo, Wog, Xos^Efs, Ch, Ch, Ch, Ch, Ch, Ch, Xos, Ch, Ch, Ch, Ch, Ch, Xos^Efs, Xos^Efs, Rrc, Rrc, Rrc, Rrc, Rrc, Rrc, Rrc, Rrc, Rrc, Rrc, Rrc, Rrc, Rrc, Rrc, Rrc, Xos^Efs, Xos^Efs, Ch, Ch, Ch, Ch, Ch, Xos^Efs, Ch, Ch, Ch, Ch, Ch, Ch, Xos^Efs, Wog, Wo
Wo, Wog, Xos, Ch, Ch, Ch, Ch, Ch, Xos, Xos, Xos, Ch, Ch, Ch, Ch, Ch, Ch, Rrc, Rrc, Rrc, Rrc, Rrc, Rrc, Rrc, Rrc, Rrc, Rrc, Rrc, Rrc, Rrc, Rrc, Rrc, Ch, Ch, Ch, Ch, Ch, Ch, Xos, Xos, Xos, Ch, Ch, Ch, Ch, Ch, Xos, Wog, Wo
Wo, Wog, Wog, Xos, Xos, Ch, Xos, Xos, Wog, Wog, Wog, Xos, Xos, Ch, Ch, Ch, Ch, Ch, Ch, Xos^Efs, Xos^Efs, Rrc, Rrc, Rrc, Rrc, Rrc, Rrc, Rrc, Xos^Efs, Xos^Efs, Ch, Ch, Ch, Ch, Ch, Ch, Xos, Xos, Wog, Wog, Wog, Xos, Xos, Ch, Xos, Xos, Wog, Wog, Wo
Wot, Wo, Wo, Wog, Wog, Xos, Wog, Wog, Wo, Wo, Wo, Wog, Wog, Xos, Xos, Ch, Ch, Ch, Ch, Ch, Ch, Xos^Efs, Xos^Efs, Rrc, Rrc, Rrc, Xos^Efs, Xos^Efs, Ch, Ch, Ch, Ch, Ch, Ch, Xos, Xos, Wog, Wog, Wo, Wo, Wo, Wog, Wog, Xos, Wog, Wog, Wo, Wo, Wot
Wot, Wot, Wot, Wo, Wo, Wog, Wo, Wo, Wot, Wot, Wot, Wo, Wo, Wog, Wog, Xos, Xos, Ch, Ch, Ch, Ch, Ch, Xos, Rrc, Rrc, Rrc, Xos, Ch, Ch, Ch, Ch, Ch, Xos, Xos, Wog, Wog, Wo, Wo, Wot, Wot, Wot, Wo, Wo, Wog, Wo, Wo, Wot, Wot, Wot
Wot, Wot, Wot, Wot, Wot, Wo, Wot, Wot, Wot, Wot, Wot, Wot, Wot, Wo, Wo, Wog, Wog, Xos, Xos, Ch, Ch, Ch, Xos^Efs, Rrc, Cud, Rrc, Xos^Efs, Ch, Ch, Ch, Xos, Xos, Wog, Wog, Wo, Wo, Wot, Wot, Wot, Wot, Wot, Wot, Wot, Wo, Wot, Wot, Wot, Wot, Wot
Wot, Wot, Wot, Wot, Wot, Wot, Wot, Wot, Wot, Wot, Wot, Wot, Wot, Wot, Wot, Wo, Wo, Wog, Wog, Xos, Xos^Efs, Xos^Efs, Cud, Cud, Cud, Cud, Cud, Xos^Efs, Xos^Efs, Xos, Wog, Wog, Wo, Wo, Wot, Wot, Wot, Wot, Wot, Wot, Wot, Wot, Wot, Wot, Wot, Wot, Wot, Wot, Wo
Wo, Wot, Wo, Wot, Wot, Wot, Wot, Wot, Wot, Wot, Wot, Wot, Wot, Wot, Wot, Wot, Wot, Wo, Wo, Wog, Xos^Efs, Cud, Cud, Cud, Cud, Cud, Cud, Cud, Xos^Efs, Wog, Wo, Wo, Wot, Wot, Wot, Wot, Wot, Wot, Wot, Wot, Wot, Wot, Wot, Wot, Wot, Wot, Wot, Wot, Wot
Wog, Wo, Wog, Wo, Wo, Wot, Wot, Wot, Wot, Wot, Wot, Wot, Wot, Wot, Wot, Wot, Wot, Wot, Wo, Wog, Xos, Cud, Cud, Cud, Cud, Cud, Cud, Cud, Xos, Wog, Wo, Wot, Wot, Wot, Wot, Wot, Wot, Wot, Wot, Wot, Wot, Wot, Wot, Wot, Wot, Wot, Wot, Wot, Wot
Xos, Wog, Xos, Wog, Wog, Wo, Wo, Wot, Wot, Wot, Wot, Wot, Wot, Wot, Wot, Wot, Wot, Wot, Wo, Wog, Wog, Xos, Xos, Cud, Rrc^Bsb|, Cud, Xos, Xos, Wog, Wog, Wot, Wot, Wot, Wot, Wot, Wot, Wot, Wot, Wot, Wot, Wot, Wot, Wot, Wot, Wot, Wot, Wot, Wot, Wot
Ch, Xos, Ch, Xos, Xos, Wog, Wog, Wo, Wo, Wot, Wot, Wot, Wot, Wot, Wot, Wot, Wot, Wot, Wot, Wo, Wo, Wog, Xos, Qxu^Bsb|, Wog^Bsb|, Rrc^Bsb|, Xos, Wog, Wot, Wot, Wot, Wot, Wot, Wot, Wot, Wot, Wot, Wot, Wot, Wot, Wot, Wot, Wot, Wot, Wot, Wot, Wot, Wot, Wot
Ch, Ch, Ch, Ch, Ch, Xos, Xos, Wog, Wog, Wo, Wo, Wot, Wot, Wot, Wot, Wot, Wot, Wot, Wot, Wot, Wo, Wog, Wog, Qxu^Bsb|, Wo^Bsb|, Wog^Bsb|, Wog, Wog, Wot, Wot, Wot, Wot, Wot, Wot, Wot, Wot, Wot, Wot, Wot, Wot, Wo, Wot, Wot, Wot, Wot, Wot, Wot, Wot, Wot
Ch, Ch, Rr^Vd, Rr^Vd, Ch, Ch, Ch, Xos, Xos, Wog, Wog, Wo, Wot, Wot, Wot, Wot, Wot, Wot, Wot, Wot, Wot, Wo, Wog, Qxu^Bsb|, Wo^Bsb|, Wo^Bsb|, Wog, Wo, Wot, Wot, Wot, Wot, Wot, Wot, Wot, Wot, Wot, Wot, Wo, Wo, Wog, Wo, Wo, Wot, Wot, Wot, Wot, Wot, Wot
Ch, Rr^Vd, Ch, Ch, Ch, Ch, Rr^Vd, Ch, Ch, Xos, Wog, Wo, Wot, Wot, Wot, Wot, Wot, Wot, Wo, Wot, Wot, Wo, Wog, Qxu^Bsb|, Wog^Bsb|, Wo^Bsb|, Wog, Wot, Wot, Wot, Wo, Wot, Wo, Wot, Wot, Wot, Wo, Wo, Wog, Wog, Xos, Wog, Wog, Wo, Wo, Wot, Wot, Wot, Wo
Ch, Ch, Ch, Ch, Ch, Ch, Rr^Vd, Ch, Ch, Xos, Wog, Wo, Wo, Wot, Wot, Wot, Wo, Wo, Wog, Wo, Wo, Wo, Wog, Qxu^Bsb|, Ch, Wog^Bsb|, Wog, Wo, Wo, Wo, Wog, Wo, Wog, Wo, Wo, Wo, Wog, Wog, Xos, Xos, Ch, Xos, Xos, Wog, Wog, Wo, Wo, Wo, Wog
Ch, Ch, Ch, Kud, Ch, Ch, Rr^Vd, Ch, Ch, Xos, Xos, Wog, Wog, Wo, Wo, Wo, Wog, Wog, Xos^Efs, Wog, Wog, Wog, Xos^Efs, Ch, Ch, Ch, Xos^Efs, Wog, Wog, Wog, Xos^Efs, Wog, Wog, Wog, Wo, Wo, Wog, Xos, Ch, Ch, Ch, Ch, Ch, Xos, Xos, Wog, Wog, Wog, Xos
Ch, Ch, Ch, Ch, Ch, Ch, Ch, Ch, Ch, Xos, Ch, Xos, Xos, Wog, Wog, Wog, Xos^Efs, Xos^Efs, Ch, Xos^Efs, Xos^Efs, Xos^Efs, Xos^Efs, Ch, Ch, Ch, Xos^Efs, Xos^Efs, Xos^Efs, Xos^Efs, Ch, Xos^Efs, Xos^Efs, Wog, Wog, Wo, Wog, Xos, Ch, Ch, Ch, Ch, Ch, Ch, Ch, Xos, Xos, Xos, Ch
Xos, Ch, Ch, Ch, Ch, Ch, Ch, Ch, Xos, Xos, Ch, Ch, Ch, Xos, Xos, Xos^Efs, Ch, Ch, Rr^Vd, Ch, Ch, Xos^Efs, Ch, Ch, Ch, Ch, Ch, Xos^Efs, Ch, Ch, Rr^Vd, Ch, Ch, Xos^Efs, Wog, Wog, Wog, Xos, Ch, Ch, Ch, Ch, Ch, Ch, Ch, Ch, Ch, Ch, Ch
Ch, Xos, Xos, Ch, Ch, Ch, Xos, Xos, Ch, Ch, Ch, Ch, Ch, Ch, Ch, Xos, Ch, Ch, Kud, Ch, Ch, Ch, Ch, Ch, Xos^Efs, Ch, Ch, Ch, Ch, Ch, Kud, Ch, Ch, Xos^Efs, Xos^Efs, Xos, Xos, Xos, Ch, Ch, Ch, Ch, Ch, Ch, Ch, Ch, Ch, Ch, Ch
Ch, Ch, Ch, Ch, Ch, Ch, Ch, Ch, Ch, Ch, Ch, Ch, Ch, Ch, Ch, Xos, Ch, Ch, Rr^Vd, Ch, Ch, Ch, Xos^Efs, Xos^Efs, Xos, Xos^Efs, Xos^Efs, Ch, Ch, Ch, Rr^Vd, Ch, Ch, Xos, Ch, Ch, Ch, Ch, Ch, Ch, Ch, Ch, Ch, Ch, Ch, Ch, Ch, Ch, Ch
Ch, Ch, Ch, Ch, Ch, Ch, Ch, Ch, Ch, Ch, Ch, Ch, Ch, Ch, Ch, Xos, Ch, Ch, Ch, Ch, Ch, Xos^Efs, Xos, Xos^Efs, Ch, Xos, Xos, Xos^Efs, Ch, Ch, Ch, Ch, Ch, Xos, Ch, Ch, Ch, Ch, Ch, Ch, Ch, Ch, Ch, Ch, Ch, Ch, Ch, Ch, Ch
Ch, Ch, Ch, Ch, Ch, Ch, Ch, Ch, Ch, Ch, Ch, Ch, Ch, Ch, Ch, Xos, Xos, Ch, Ch, Ch, Xos, Xos, Ch, Ch, Ch, Ch, Ch, Xos, Xos, Ch, Ch, Ch, Xos, Xos, Ch, Ch, Ch, Ch, Ch, Ch, Ch, Ch, Ch, Ch, Ch, Ch, Ch, Ch, Ch
Ch, Ch, Ch, Ch, Ch, Ch, Ch, Ch, Ch, Ch, Ch, Ch, Ch, Ch, Ch, Ch, Ch, Ch, Ch, Ch, Ch, Ch, Ch, Ch, Ch, Ch, Ch, Ch, Ch, Ch, Ch, Ch, Ch, Ch, Ch, Ch, Ch, Ch, Ch, Ch, Ch, Ch, Ch, Ch, Ch, Ch, Ch, Ch, Ch
Ch, Ch, Ch, Ch, Ch, Ch, Ch, Ch, Ch, Ch, Ch, Ch, Ch, Ch, Ch, Ch, Ch, Ch, Ch, Ch, Ch, Ch, Ch, Ch, Ch, Ch, Ch, Ch, Ch, Ch, Ch, Ch, Ch, Ch, Ch, Ch, Ch, Ch, Ch, Ch, Ch, Ch, Ch, Ch, Ch, Ch, Ch, Ch, Ch
Ch, Ch, Ch, Ch, Ch, Ch, Ch, Ch, Ch, Ch, Ch, Ch, Ch, Ch, Ch, Ch, Ch, Ch, Ch, Ch, Ch, Ch, Ch, Ch, Xos^Efs, Ch, Ch, Ch, Ch, Ch, Ch, Ch, Ch, Ch, Ch, Ch, Ch, Ch, Ch, Ch, Ch, Ch, Ch, Ch, Ch, Ch, Ch, Ch, Ch
Ch, Ch, Ch, Ch, Rrc, Ch, Ch, Ch, Ch, Ch, Ch, Ch, Ch, Ch, Ch, Ch, Ch, Ch, Xos^Efs, Xos^Efs, Ch, Ch, Xos^Efs, Xos^Efs, Ch, Xos^Efs, Xos^Efs, Ch, Ch, Xos^Efs, Xos^Efs, Ch, Ch, Ch, Ch, Ch, Ch, Ch, Ch, Ch, Ch, Ch, Ch, Ch, Ch, Ch, Ch, Ch, Ch
Ch, Ch, Rrc, Rrc, Rrc, Rrc, Rrc, Ch, Ch, Ch, Ch, Ch, Ch, Ch, Ch, Ch, Ch, Ch, Xos^Efs, Ch, Rr^Vd, Ch, Ch, Ch, Ch, Ch, Ch, Ch, Rr^Vd, Ch, Xos, Ch, Ch, Ch, Ch, Ch, Ch, Ch, Ch, Ch, Ch, Ch, Ch, Ch, Ch, Ch, Ch, Ch, Ch
Rrc, Rrc, Rrc, Rrc, Ch, Rrc, Rrc, Rrc, Rrc, Ch, Ch, Ch, Ch, Ch, Ch, Ch, Ch, Ch, Xos, Ch, Rr^Vd, Ch, Ch, Ch, Kud, Ch, Ch, Ch, Rr^Vd, Ch, Xos, Ch, Ch, Ch, Ch, Ch, Ch, Ch, Ch, Ch, Ch, Ch, Ch, Ch, Ch, Ch, Ch, Ch, Ch
Rrc, Rrc, Ch, Ch, Ch, Ch, Ch, Rrc, Rrc, Ch, Ch, Ch, Ch, Ch, Ch, Ch, Ch, Ch, Xos, Ch, Rr^Vd, Ch, Ch, Ch, Ch, Ch, Ch, Ch, Rr^Vd, Ch, Xos, Ch, Ch, Ch, Ch, Ch, Ch, Ch, Ch, Ch, Ch, Ch, Ch, Ch, Ch, Ch, Ch, Ch, Ch
Rrc, Rrc, Ch, Ch, Kud, Ch, Ch, Rrc, Rrc, Ch, Ch, Ch, Ch, Ch, Ch, Ch, Ch, Ch, Xos, Ch, Ch, Ch, Xos, Ch, Ch, Ch, Xos, Ch, Ch, Ch, Xos, Ch, Ch, Ch, Ch, Ch, Ch, Ch, Ch, Ch, Ch, Ch, Ch, Ch, Ch, Ch, Ch, Ch, Ch
Rrc, Rrc, Ch, Ch, Ch, Ch, Ch, Rrc, Rrc, Ch, Ch, Ch, Ch, Ch, Ch, Ch, Ch, Ch, Ch, Xos, Ch, Ch, Ch, Xos, Xos, Xos, Ch, Ch, Ch, Xos, Ch, Ch, Ch, Ch, Ch, Ch, Ch, Ch, Ch, Ch, Ch, Ch, Ch, Ch, Ch, Ch, Ch, Ch, Ch
Rrc, Rrc, Rrc, Ch, Ch, Ch, Rrc, Rrc, Rrc, Ch, Ch, Ch, Ch, Ch, Ch, Ch, Ch, Ch, Ch, Ch, Ch, Ch, Ch, Ch, Ch, Ch, Ch, Ch, Ch, Ch, Ch, Ch, Ch, Ch, Ch, Ch, Ch, Ch, Ch, Ch, Ch, Ch, Ch, Ch, Ch, Ch, Ch, Ch, Ch
Rrc, Rrc, Rrc, Rrc, Rrc, Rrc, Rrc, Rrc, Ch, Ch, Ch, Ch, Ch, Ch, Ch, Ch, Ch, Ch, Ch, Ch, Ch, Ch, Ch, Ch, Ch, Ch, Ch, Ch, Ch, Ch, Ch, Ch, Ch, Ch, Ch, Ch, Ch, Ch, Ch, Ch, Ch, Ch, Ch, Ch, Ch, Ch, Ch, Ch, Ch
