border_size=1
usage=map

Wot         , Wot         , Wot         , Wot         , Wot         , Wot         , Wot         , Wot         , Wot         , Wot         , Wo          , Wog         , Xos         , Ch          , Ch          , Ch          , Ch          , Ch          , Ch          , Ch          , Xos         , Wog         , Wo          , Wot         , Wot         , Wot         , Wo          , Wog         , Xos         , Ch          , Ch          , Ch          , Ch          , Ch          , Ch          , Ch          , Xos         , Wog         , Wo          , Wot         , Wot         , Wot         , Wot         , Wot         , Wot         , Wot         , Wot         , Wot         , Wot         
Wot         , Wot         , Wot         , Wot         , Wot         , Wot         , Wot         , Wot         , Wot         , Wot         , Wo          , Wog         , Xos         , Ch          , Ch          , Kud         , Ch          , Ch          , Ch          , Ch          , Xos^Efs         , Wog         , Wo          , Wot         , Wot         , Wot         , Wo          , Wog         , Xos^Efs         , Ch          , Ch          , Ch          , Ch          , Kud         , Ch          , Ch          , Xos         , Wog         , Wo          , Wot         , Wot         , Wot         , Wot         , Wot         , Wot         , Wot         , Wot         , Wot         , Wot         
Wot         , Wot         , Wot         , Wot         , Wot         , Wot         , Wot         , Wot         , Wot         , Wot         , Wo          , Wog         , Xos         , Ch          , Ch          , Ch          , Ch          , Ch          , Rrc         , Rrc         , Xos         , Wog         , Wog         , Wo          , Wo          , Wo          , Wog         , Wog         , Xos         , Rrc         , Rrc         , Ch          , Ch          , Ch          , Ch          , Ch          , Xos         , Wog         , Wo          , Wot         , Wot         , Wot         , Wot         , Wot         , Wot         , Wot         , Wot         , Wot         , Wot         
Wot         , Wot         , Wot         , Wot         , Wot         , Wot         , Wot         , Wot         , Wot         , Wot         , Wo          , Wog         , Xos^Efs         , Rrc         , Rrc         , Ch          , Xos^Efs         , Xos^Efs         , Rrc         , Rrc         , Rrc         , Xos         , Xos         , Wog         , Wog         , Wog         , Xos         , Xos         , Rrc         , Rrc         , Rrc         , Xos^Efs         , Xos^Efs         , Ch          , Rrc         , Rrc         , Xos^Efs         , Wog         , Wo          , Wot         , Wot         , Wot         , Wot         , Wot         , Wot         , Wot         , Wot         , Wot         , Wot         
Wot         , Wot         , Wot         , Wot         , Wot         , Wot         , Wot         , Wot         , Wot         , Wot         , Wo          , Wog         , Xos^Efs         , Rrc         , Rrc         , Xos^Efs         , Rrc         , Rrc         , Rrc         , Rrc         , Rrc         , Rrc         , Rrc         , Xos         , Xos         , Xos         , Rrc         , Rrc         , Rrc         , Rrc         , Rrc         , Rrc         , Rrc         , Xos^Efs         , Rrc         , Rrc         , Xos^Efs         , Wo          , Wo          , Wot         , Wot         , Wot         , Wot         , Wot         , Wot         , Wot         , Wot         , Wot         , Wot         
Wot         , Wot         , Wot         , Wot         , Wot         , Wot         , Wot         , Wot         , Wo          , Wo          , Wog         , Wog         , Xos^Efs         , Rrc         , Rrc         , Xos^Efs         , Rrc         , Rrc         , Rrc         , Rrc         , Rrc         , Rrc         , Xos^Efs         , Xos^Efs         , Rrc         , Xos^Efs         , Xos^Efs         , Rrc         , Rrc         , Rrc         , Rrc         , Rrc         , Rrc         , Xos^Efs         , Rrc         , Rrc         , Xos^Efs         , Wog         , Wog         , Wo          , Wo          , Wot         , Wot         , Wot         , Wot         , Wot         , Wot         , Wot         , Wot         
Wot         , Wot         , Wot         , Wot         , Wot         , Wot         , Wo          , Wo          , Wog         , Wog         , Xos^Efs         , Xos^Efs         , Rrc         , Rrc         , Rrc         , Xos^Efs         , Rrc         , Rrc         , Rrc         , Rrc         , Xos^Efs         , Xos^Efs         , Rrc         , Rrc         , Rrc         , Rrc         , Rrc         , Xos^Efs         , Xos^Efs         , Rrc         , Rrc         , Rrc         , Rrc         , Xos^Efs         , Rrc         , Rrc         , Rrc         , Xos^Efs         , Xos^Efs         , Wog         , Wog         , Wo          , Wo          , Wot         , Wot         , Wot         , Wot         , Wot         , Wot         
Wot         , Wot         , Wot         , Wot         , Wo          , Wo          , Wog         , Wog         , Xos^Efs         , Xos^Efs         , Rrc         , Rrc         , Rrc         , Rrc         , Xos^Efs         , Xos^Efs         , Xos^Efs         , Rrc         , Xos^Efs         , Xos^Efs         , Rrc         , Rrc         , Rrc         , Rrc         , Rrc         , Rrc         , Rrc         , Rrc         , Rrc         , Xos^Efs         , Xos^Efs         , Rrc         , Xos^Efs         , Xos^Efs         , Xos^Efs         , Rrc         , Rrc         , Rrc         , Rrc         , Xos^Efs         , Xos^Efs         , Wog         , Wog         , Wo          , Wo          , Wot         , Wot         , Wot         , Wot         
Wot         , Wot         , Wo          , Wo          , Wog         , Wog         , Xos^Efs         , Xos^Efs         , Rrc         , Rrc         , Rrc         , Rrc         , Xos^Efs         , Xos^Efs         , Rrc         , Rrc         , Rrc         , Xos^Efs         , Xos^Efs         , Rrc         , Rrc         , Rrc         , Rrc         , Rrc         , Rrc         , Rrc         , Rrc         , Rrc         , Rrc         , Rrc         , Xos^Efs         , Xos^Efs         , Rrc         , Rrc         , Rrc         , Xos^Efs         , Xos^Efs         , Rrc         , Rrc         , Rrc         , Rrc         , Xos^Efs         , Xos^Efs         , Wog         , Wog         , Wo          , Wo          , Wot         , Wot         
Wot         , Wo          , Wo          , Wog         , Xos^Efs         , Xos^Efs         , Rrc         , Rrc         , Rrc         , Rrc         , Xos^Efs         , Xos^Efs         , Rrc         , Rrc         , Rrc         , Rrc         , Rrc         , Rrc         , Rrc         , Xos^Efs         , Xos^Efs         , Rrc         , Rrc         , Rrc         , Rrc         , Rrc         , Rrc         , Rrc         , Xos^Efs         , Xos^Efs         , Rrc         , Rrc         , Rrc         , Rrc         , Rrc         , Rrc         , Rrc         , Xos^Efs         , Xos^Efs         , Rrc         , Rrc         , Rrc         , Rrc         , Xos^Efs         , Xos^Efs         , Wog         , Wog         , Wo          , Wot         
Wot         , Wo          , Wog         , Xos^Efs         , Rrc         , Rrc         , Rrc         , Rrc         , Xos^Efs         , Xos^Efs         , Ch          , Ch          , Ch          , Rrc         , Rrc         , Rrc         , Rrc         , Rrc         , Rrc         , Rrc         , Rrc         , Xos^Efs         , Xos^Efs         , Rrc         , Rrc         , Rrc         , Xos^Efs         , Xos^Efs         , Rrc         , Rrc         , Rrc         , Rrc         , Rrc         , Rrc         , Rrc         , Rrc         , Ch          , Ch          , Ch          , Xos^Efs         , Xos^Efs         , Rrc         , Rrc         , Rrc         , Rrc         , Xos^Efs         , Wog         , Wo          , Wot         
Wot         , Wo          , Wog         , Xos^Efs         , Rrc         , Rrc         , Xos^Efs         , Xos^Efs         , Ch          , Ch          , 7 Kud       , Ch          , Ch          , Ch          , Ch          , Xos^Efs         , Xos^Efs         , Rrc         , Rrc         , Rrc         , Rrc         , Rrc         , Rrc         , Rrc         , Ch          , Rrc         , Rrc         , Rrc         , Rrc         , Rrc         , Rrc         , Rrc         , Xos^Efs         , Xos^Efs         , Ch          , Ch          , Ch          , Ch          , 8 Kud       , Ch          , Ch          , Xos^Efs         , Xos^Efs         , Rrc         , Rrc         , Xos^Efs         , Wog         , Wo          , Wot         
Wo          , Wo          , Wog         , Xos^Efs         , Rrc         , Rrc         , Ch          , Xos^Efs         , Xos^Efs         , Ch          , Ch          , Ch          , Xos^Efs         , Ch          , Ch          , Ch          , Ch          , Xos^Efs         , Xos^Efs         , Rrc         , Rrc         , Rrc         , Ch          , Ch          , Ch          , Ch          , Ch          , Rrc         , Rrc         , Rrc         , Xos^Efs         , Xos^Efs         , Ch          , Ch          , Ch          , Ch          , Xos^Efs         , Ch          , Ch          , Ch          , Xos^Efs         , Xos^Efs         , Ch          , Rrc         , Rrc         , Xos^Efs         , Wog         , Wo          , Wo          
Wo          , Wog         , Xos^Efs         , Xos^Efs         , Ch          , Ch          , Ch          , Ch          , Ch          , Xos^Efs         , Xos^Efs         , Xos^Efs         , Ch          , Ch          , Ch          , Ch          , Ch          , Ch          , Xos^Efs         , Xos^Efs         , Ch          , Ch          , Ch          , Ch          , Ch          , Ch          , Ch          , Ch          , Ch          , Xos^Efs         , Xos^Efs         , Ch          , Ch          , Ch          , Ch          , Ch          , Ch          , Xos^Efs         , Xos^Efs         , Xos^Efs         , Ch          , Ch          , Ch          , Ch          , Ch          , Xos^Efs         , Xos^Efs         , Wog         , Wo          
Wo          , Wog         , Xos^Efs         , Ch          , Ch          , Ch          , Ch          , Ch          , Ch          , Xos^Efs         , Ch          , Ch          , Ch          , Ch          , Ch          , Ch          , Xos^Efs         , Xos^Efs         , Ch          , Ch          , Ch          , Ch          , Ch          , Ch          , Ch          , Ch          , Ch          , Ch          , Ch          , Ch          , Ch          , Xos^Efs         , Xos^Efs         , Ch          , Ch          , Ch          , Ch          , Ch          , Ch          , Xos^Efs         , Ch          , Ch          , Ch          , Ch          , Ch          , Ch          , Xos^Efs         , Wog         , Wo          
Wo          , Wog         , Xos^Efs         , Ch          , Ch          , Ch          , Ch          , Ch          , Ch          , Xos^Efs         , Ch          , Ch          , Ch          , Ch          , Xos^Efs         , Xos^Efs         , Ch          , Ch          , Ch          , Ch          , Ch          , Ch          , Ch          , Ch          , Ch          , Ch          , Ch          , Ch          , Ch          , Ch          , Ch          , Ch          , Ch          , Xos^Efs         , Xos^Efs         , Ch          , Ch          , Ch          , Ch          , Xos^Efs         , Ch          , Ch          , Ch          , Ch          , Ch          , Ch          , Xos^Efs         , Wog         , Wo          
Wo          , Wog         , Xos^Efs         , Ch          , Ch          , 9 Kud       , Ch          , Ch          , Ch          , Xos^Efs         , Ch          , Ch          , Ch          , Xos^Efs         , Xos^Efs         , Ch          , Ch          , Ch          , Ch          , Ch          , Ch          , Ch          , Ch          , Ch          , Ch          , Ch          , Ch          , Ch          , Ch          , Ch          , Ch          , Ch          , Ch          , Ch          , Xos^Efs         , Xos^Efs         , Ch          , Ch          , Ch          , Xos^Efs         , Ch          , Ch          , Ch          , Kud         , Ch          , Ch          , Xos^Efs         , Wog         , Wo          
Wo          , Wog         , Xos^Efs         , Ch          , Ch          , Ch          , Ch          , Ch          , Ch          , Xos^Efs         , Ch          , Ch          , Ch          , Ch          , Ch          , Xos^Efs         , Xos^Efs         , Ch          , Ch          , Ch          , Ch          , Ch          , 2 Kud       , Ch          , Ch          , Ch          , 3 Kud       , Ch          , Ch          , Ch          , Ch          , Ch          , Xos^Efs         , Xos^Efs         , Ch          , Ch          , Ch          , Ch          , Ch          , Xos^Efs         , Ch          , Ch          , Ch          , Ch          , Ch          , Ch          , Xos^Efs         , Wog         , Wo          
Wo          , Wog         , Xos^Efs         , Ch          , Ch          , Ch          , Ch          , Ch          , Rrc         , Xos^Efs         , Xos^Efs         , Ch          , Ch          , Ch          , Ch          , Ch          , Ch          , Xos^Efs         , Xos^Efs         , Ch          , Ch          , Ch          , Ch          , Ch          , Ch          , Ch          , Ch          , Ch          , Ch          , Ch          , Xos^Efs         , Xos^Efs         , Ch          , Ch          , Ch          , Ch          , Ch          , Ch          , Xos^Efs         , Xos^Efs         , Rrc         , Ch          , Ch          , Ch          , Ch          , Ch          , Xos^Efs         , Wog         , Wo          
Wo          , Wog         , Wog         , Xos^Efs         , Xos^Efs         , Ch          , Xos^Efs         , Rrc         , Rrc         , Rrc         , Rrc         , Xos^Efs         , Rrc         , Ch          , Ch          , Ch          , Ch          , Ch          , Xos^Efs         , Xos^Efs         , Xos^Efs         , Ch          , Ch          , Ch          , Ch          , Ch          , Ch          , Ch          , Xos^Efs         , Xos^Efs         , Xos^Efs         , Ch          , Ch          , Ch          , Ch          , Ch          , Rrc         , Xos^Efs         , Rrc         , Rrc         , Rrc         , Rrc         , Xos^Efs         , Ch          , Xos         , Xos         , Wog         , Wog         , Wo          
Wot         , Wo          , Wo          , Wog         , Wog         , Xos^Efs         , Rrc         , Rrc         , Rrc         , Rrc         , Rrc         , Rrc         , Rrc         , Rrc         , Xos^Efs         , Ch          , Xos^Efs         , Xos^Efs         , Ch          , Ch          , Ch          , Xos^Efs         , Xos^Efs         , Ch          , Ch          , Ch          , Xos^Efs         , Xos^Efs         , Ch          , Ch          , Ch          , Xos^Efs         , Xos^Efs         , Ch          , Xos^Efs         , Rrc         , Rrc         , Rrc         , Rrc         , Rrc         , Rrc         , Rrc         , Rrc         , Xos         , Wog         , Wog         , Wo          , Wo          , Wot         
Wot         , Wot         , Wot         , Wo          , Wog         , Xos         , Rrc         , Rrc         , Rrc         , Rrc         , Rrc         , Rrc         , Rrc         , Rrc         , Xos^Efs         , Xos^Efs         , Ch          , Ch          , Ch          , Ch          , Ch          , Ch          , Ch          , Xos^Efs         , Xos^Efs         , Xos^Efs         , Ch          , Ch          , Ch          , Ch          , Ch          , Ch          , Ch          , Xos^Efs         , Xos^Efs         , Rrc         , Rrc         , Rrc         , Rrc         , Rrc         , Rrc         , Rrc         , Rrc         , Xos         , Wog         , Wo          , Wot         , Wot         , Wot         
Wot         , Wot         , Wot         , Wo          , Wog         , Xos         , Rrc         , Rrc         , Rrc         , Rrc         , Rrc         , Rrc         , Xos^Efs         , Xos^Efs         , Ch          , Ch          , Ch          , Ch          , Ch          , Ch          , Ch          , Ch          , Xos^Efs         , Xos^Efs         , Ch          , Xos^Efs         , Xos^Efs         , Ch          , Ch          , Ch          , Ch          , Ch          , Ch          , Ch          , Ch          , Xos^Efs         , Xos^Efs         , Rrc         , Rrc         , Rrc         , Rrc         , Rrc         , Rrc         , Xos         , Wog         , Wo          , Wot         , Wot         , Wot         
Wot         , Wot         , Wot         , Wo          , Wog         , Xos         , Rrc         , Rrc         , Rrc         , Rrc         , Rrc         , Xos^Efs         , Xos^Efs         , Ch          , Ch          , Ch          , Ch          , Ch          , Ch          , Ch          , Xos^Efs         , Xos^Efs         , Ch          , Ch          , Ch          , Ch          , Ch          , Xos^Efs         , Xos^Efs         , Ch          , Ch          , Ch          , Ch          , Ch          , Ch          , Ch          , Xos^Efs         , Xos^Efs         , Rrc         , Rrc         , Rrc         , Rrc         , Rrc         , Xos         , Wog         , Wo          , Wot         , Wot         , Wot         
Wot         , Wot         , Wo          , Wo          , Wog         , Xos         , Rrc         , Rrc         , Rrc         , Rrc         , Rrc         , Rrc         , Rrc         , Rrc         , Rrc         , Ch          , Ch          , Ch          , Xos^Efs         , Xos^Efs         , Ch          , Ch          , Ch          , Ch          , 4 Kud       , Ch          , Ch          , Ch          , Ch          , Xos^Efs         , Xos^Efs         , Ch          , Ch          , Ch          , Rrc         , Rrc         , Rrc         , Rrc         , Rrc         , Rrc         , Rrc         , Rrc         , Rrc         , Xos         , Wog         , Wo          , Wo          , Wot         , Wot         
Wo          , Wo          , Wog         , Wog         , Xos^Efs         , Xos^Efs         , Xos^Efs         , Rrc         , Rrc         , Rrc         , Rrc         , Rrc         , Rrc         , Rrc         , Rrc         , Xos^Efs         , Xos^Efs         , Xos^Efs         , Ch          , Ch          , Ch          , Ch          , Ch          , Ch          , Ch          , Ch          , Ch          , Ch          , Ch          , Ch          , Ch          , Xos^Efs         , Xos^Efs         , Xos^Efs         , Rrc         , Rrc         , Rrc         , Rrc         , Rrc         , Rrc         , Rrc         , Rrc         , Xos^Efs         , Xos^Efs         , Xos^Efs         , Wog         , Wog         , Wo          , Wo          
Wo          , Wog         , Xos^Efs         , Xos^Efs         , Ch          , Ch          , Ch          , Rrc         , Rrc         , Rrc         , Rrc         , Rrc         , Rrc         , Rrc         , Rrc         , Rrc         , Rrc         , Xos^Efs         , Xos^Efs         , Ch          , Ch          , Ch          , Ch          , Ch          , Ch          , Ch          , Ch          , Ch          , Ch          , Ch          , Xos^Efs         , Xos^Efs         , Rrc         , Rrc         , Rrc         , Rrc         , Rrc         , Rrc         , Rrc         , Rrc         , Rrc         , Rrc         , Ch          , Ch          , Ch          , Xos^Efs         , Xos^Efs         , Wog         , Wo          
Wo          , Wog         , Xos^Efs         , Ch          , Ch          , Ch          , Ch          , Ch          , Ch          , Xos^Efs         , Xos^Efs         , Rrc         , Rrc         , Rrc         , Rrc         , Rrc         , Rrc         , Rrc         , Rrc         , Rrc         , Rrc         , Ch          , Ch          , Ch          , Ch          , Ch          , Ch          , Ch          , Rrc         , Rrc         , Rrc         , Rrc         , Rrc         , Rrc         , Rrc         , Rrc         , Rrc         , Rrc         , Xos^Efs         , Xos^Efs         , Ch          , Ch          , Ch          , Ch          , Ch          , Ch          , Xos^Efs         , Wog         , Wo          
Wo          , Wog         , Xos^Efs         , Ch          , Ch          , Ch          , Ch          , Ch          , Ch          , Xos         , Ch          , Xos^Efs         , Xos^Efs         , Rrc         , Rrc         , Rrc         , Rrc         , Rrc         , Rrc         , Rrc         , Rrc         , Xos^Efs         , Xos^Efs         , Ch          , Ch          , Ch          , Xos^Efs         , Xos^Efs         , Rrc         , Rrc         , Rrc         , Rrc         , Rrc         , Rrc         , Rrc         , Rrc         , Xos^Efs         , Xos^Efs         , Ch          , Xos^Efs         , Ch          , Ch          , Ch          , Ch          , Ch          , Ch          , Xos^Efs         , Wog         , Wo          
Wo          , Wog         , Xos^Efs         , Ch          , Ch          , 5 Kud       , Ch          , Ch          , Ch          , Xos         , Ch          , Ch          , Ch          , Xos^Efs         , Xos^Efs         , Rrc         , Rrc         , Rrc         , Rrc         , Rrc         , Rrc         , Rrc         , Rrc         , Xos^Efs         , Xos^Efs         , Xos^Efs         , Rrc         , Rrc         , Rrc         , Rrc         , Rrc         , Rrc         , Rrc         , Rrc         , Xos^Efs         , Xos^Efs         , Ch          , Ch          , Ch          , Xos^Efs         , Ch          , Ch          , Ch          , 6 Kud       , Ch          , Ch          , Xos^Efs         , Wog         , Wo          
Wo          , Wog         , Xos^Efs         , Ch          , Ch          , Ch          , Ch          , Ch          , Ch          , Xos         , Ch          , Ch          , Ch          , Ch          , Ch          , Xos^Efs         , Xos^Efs         , Rrc         , Rrc         , Rrc         , Rrc         , Rrc         , Rrc         , Rrc         , Rrc         , Rrc         , Rrc         , Rrc         , Rrc         , Rrc         , Rrc         , Rrc         , Xos^Efs         , Xos^Efs         , Ch          , Ch          , Ch          , Ch          , Ch          , Xos^Efs         , Ch          , Ch          , Ch          , Ch          , Ch          , Ch          , Xos^Efs         , Wog         , Wo          
Wo          , Wog         , Xos         , Ch          , Ch          , Ch          , Ch          , Ch          , Xos         , Xos         , Xos         , Ch          , Ch          , Ch          , Ch          , Ch          , Ch          , Rrc         , Rrc         , Rrc         , Rrc         , Rrc         , Rrc         , Rrc         , Rrc         , Rrc         , Rrc         , Rrc         , Rrc         , Rrc         , Rrc         , Rrc         , Ch          , Ch          , Ch          , Ch          , Ch          , Ch          , Xos         , Xos         , Xos         , Ch          , Ch          , Ch          , Ch          , Ch          , Xos         , Wog         , Wo          
Wo          , Wog         , Wog         , Xos         , Xos         , Ch          , Xos         , Xos         , Wog         , Wog         , Wog         , Xos         , Xos         , Ch          , Ch          , Ch          , Ch          , Ch          , Ch          , Xos^Efs         , Xos^Efs         , Rrc         , Rrc         , Rrc         , Rrc         , Rrc         , Rrc         , Rrc         , Xos^Efs         , Xos^Efs         , Ch          , Ch          , Ch          , Ch          , Ch          , Ch          , Xos         , Xos         , Wog         , Wog         , Wog         , Xos         , Xos         , Ch          , Xos         , Xos         , Wog         , Wog         , Wo          
Wot         , Wo          , Wo          , Wog         , Wog         , Xos         , Wog         , Wog         , Wo          , Wo          , Wo          , Wog         , Wog         , Xos         , Xos         , Ch          , Ch          , Ch          , Ch          , Ch          , Ch          , Xos^Efs         , Xos^Efs         , Rrc         , Rrc         , Rrc         , Xos^Efs         , Xos^Efs         , Ch          , Ch          , Ch          , Ch          , Ch          , Ch          , Xos         , Xos         , Wog         , Wog         , Wo          , Wo          , Wo          , Wog         , Wog         , Xos         , Wog         , Wog         , Wo          , Wo          , Wot         
Wot         , Wot         , Wot         , Wo          , Wo          , Wog         , Wo          , Wo          , Wot         , Wot         , Wot         , Wo          , Wo          , Wog         , Wog         , Xos         , Xos         , Ch          , Ch          , Ch          , Ch          , Ch          , Xos         , Rrc         , Rrc         , Rrc         , Xos         , Ch          , Ch          , Ch          , Ch          , Ch          , Xos         , Xos         , Wog         , Wog         , Wo          , Wo          , Wot         , Wot         , Wot         , Wo          , Wo          , Wog         , Wo          , Wo          , Wot         , Wot         , Wot         
Wot         , Wot         , Wot         , Wot         , Wot         , Wo          , Wot         , Wot         , Wot         , Wot         , Wot         , Wot         , Wot         , Wo          , Wo          , Wog         , Wog         , Xos         , Xos         , Ch          , Ch          , Ch          , Xos^Efs         , Rrc         , Cud         , Rrc         , Xos^Efs         , Ch          , Ch          , Ch          , Xos         , Xos         , Wog         , Wog         , Wo          , Wo          , Wot         , Wot         , Wot         , Wot         , Wot         , Wot         , Wot         , Wo          , Wot         , Wot         , Wot         , Wot         , Wot         
Wot         , Wot         , Wot         , Wot         , Wot         , Wot         , Wot         , Wot         , Wot         , Wot         , Wot         , Wot         , Wot         , Wot         , Wot         , Wo          , Wo          , Wog         , Wog         , Xos         , Xos^Efs         , Xos^Efs         , Cud         , Cud         , Cud         , Cud         , Cud         , Xos^Efs         , Xos^Efs         , Xos         , Wog         , Wog         , Wo          , Wo          , Wot         , Wot         , Wot         , Wot         , Wot         , Wot         , Wot         , Wot         , Wot         , Wot         , Wot         , Wot         , Wot         , Wot         , Wo          
Wo          , Wot         , Wo          , Wot         , Wot         , Wot         , Wot         , Wot         , Wot         , Wot         , Wot         , Wot         , Wot         , Wot         , Wot         , Wot         , Wot         , Wo          , Wo          , Wog         , Xos^Efs         , Cud         , Cud         , Cud         , 1 Cud^Ii    , Cud         , Cud         , Cud         , Xos^Efs         , Wog         , Wo          , Wo          , Wot         , Wot         , Wot         , Wot         , Wot         , Wot         , Wot         , Wot         , Wot         , Wot         , Wot         , Wot         , Wot         , Wot         , Wot         , Wot         , Wot         
Wog         , Wo          , Wog         , Wo          , Wo          , Wot         , Wot         , Wot         , Wot         , Wot         , Wot         , Wot         , Wot         , Wot         , Wot         , Wot         , Wot         , Wot         , Wo          , Wog         , Xos         , Cud         , Cud         , Cud         , Cud         , Cud         , Cud         , Cud         , Xos         , Wog         , Wo          , Wot         , Wot         , Wot         , Wot         , Wot         , Wot         , Wot         , Wot         , Wot         , Wot         , Wot         , Wot         , Wot         , Wot         , Wot         , Wot         , Wot         , Wot         
Xos         , Wog         , Xos         , Wog         , Wog         , Wo          , Wo          , Wot         , Wot         , Wot         , Wot         , Wot         , Wot         , Wot         , Wot         , Wot         , Wot         , Wot         , Wo          , Wog         , Wog         , Xos         , Xos         , Cud         , Cud         , Cud         , Xos         , Xos         , Wog         , Wog         , Wot         , Wot         , Wot         , Wot         , Wot         , Wot         , Wot         , Wot         , Wot         , Wot         , Wot         , Wot         , Wot         , Wot         , Wot         , Wot         , Wot         , Wot         , Wot         
Ch          , Xos         , Ch          , Xos         , Xos         , Wog         , Wog         , Wo          , Wo          , Wot         , Wot         , Wot         , Wot         , Wot         , Wot         , Wot         , Wot         , Wot         , Wot         , Wo          , Wo          , Wog         , Xos         , Xos         , Xos         , Xos         , Xos         , Wog         , Wot         , Wot         , Wot         , Wot         , Wot         , Wot         , Wot         , Wot         , Wot         , Wot         , Wot         , Wot         , Wot         , Wot         , Wot         , Wot         , Wot         , Wot         , Wot         , Wot         , Wot         
Ch          , Ch          , Ch          , Ch          , Ch          , Xos         , Xos         , Wog         , Wog         , Wo          , Wo          , Wot         , Wot         , Wot         , Wot         , Wot         , Wot         , Wot         , Wot         , Wot         , Wo          , Wog         , Wog         , Wog         , Wog         , Wog         , Wog         , Wog         , Wot         , Wot         , Wot         , Wot         , Wot         , Wot         , Wot         , Wot         , Wot         , Wot         , Wot         , Wot         , Wo          , Wot         , Wot         , Wot         , Wot         , Wot         , Wot         , Wot         , Wot         
